w0,w1,w2,w3,w4,total,mean_age,date
115,46,48,29,39,277,13.368231046931408,2022-04-22
109,49,42,29,43,272,13.75,2022-04-21
115,45,44,27,40,271,13.47970479704797,2022-04-20
104,50,46,27,40,267,13.49438202247191,2022-04-19
100,55,45,26,39,265,13.403773584905661,2022-04-18
104,63,42,25,39,273,12.87912087912088,2022-04-17
96,66,40,28,35,265,12.81132075471698,2022-04-16
81,75,38,31,32,257,13.171206225680933,2022-04-15
83,77,42,31,30,263,12.844106463878328,2022-04-14
88,72,39,32,23,254,12.641732283464567,2022-04-13
98,66,41,33,19,257,11.96887159533074,2022-04-12
105,63,39,32,19,258,11.709302325581396,2022-04-11
115,63,34,34,23,269,11.58364312267658,2022-04-10
119,65,39,33,23,279,11.379928315412187,2022-04-09
120,61,46,30,26,283,11.586572438162545,2022-04-08
117,67,49,32,34,299,12.424749163879598,2022-04-07
111,67,53,25,35,291,13.254295532646049,2022-04-06
112,70,52,27,36,297,12.808080808080808,2022-04-05
106,64,51,27,33,281,12.754448398576512,2022-04-04
99,64,49,29,28,269,12.684014869888475,2022-04-03
102,67,47,35,35,286,13.094405594405595,2022-04-02
108,71,44,32,39,294,13.095238095238095,2022-04-01
108,71,46,36,33,294,12.92517006802721,2022-03-31
114,70,42,31,33,290,12.803448275862069,2022-03-30
114,73,39,29,32,287,12.536585365853659,2022-03-29
107,79,43,34,27,290,12.389655172413793,2022-03-28
111,73,53,28,29,294,12.60204081632653,2022-03-27
110,72,52,26,27,287,12.289198606271777,2022-03-26
120,67,49,27,28,291,11.951890034364261,2022-03-25
117,70,48,21,28,284,11.672535211267606,2022-03-24
121,60,44,21,25,271,11.52029520295203,2022-03-23
123,61,41,20,23,268,11.317164179104477,2022-03-22
121,60,45,15,27,268,11.283582089552239,2022-03-21
114,73,35,13,26,261,11.019157088122606,2022-03-20
116,73,34,11,26,260,10.553846153846154,2022-03-19
109,69,37,15,21,251,10.51792828685259,2022-03-18
120,66,30,16,20,252,10.103174603174603,2022-03-17
111,60,29,14,18,232,10.137931034482758,2022-03-16
105,54,31,13,17,220,10.25,2022-03-15
108,57,25,15,18,223,10.130044843049328,2022-03-14
117,47,22,17,16,219,9.666666666666666,2022-03-13
111,50,19,18,17,215,9.762790697674419,2022-03-12
110,51,22,15,16,214,9.476635514018692,2022-03-11
107,54,35,18,19,233,10.669527896995708,2022-03-10
106,53,29,16,19,223,10.493273542600896,2022-03-09
107,63,19,21,20,230,10.943478260869565,2022-03-08
116,46,22,22,18,224,10.611607142857142,2022-03-07
114,49,33,18,19,233,10.725321888412017,2022-03-06
120,44,33,20,17,234,10.32905982905983,2022-03-05
122,52,29,19,20,242,10.305785123966942,2022-03-04
109,49,34,17,23,232,10.935344827586206,2022-03-03
107,45,31,23,21,227,11.361233480176212,2022-03-02
118,32,36,20,22,228,11.276315789473685,2022-03-01
108,43,35,18,23,227,11.431718061674008,2022-02-28
113,59,28,17,24,241,11.095435684647303,2022-02-27
113,47,29,17,22,228,11.017543859649123,2022-02-26
120,47,29,18,21,235,10.680851063829786,2022-02-25
119,52,26,20,18,235,10.119148936170212,2022-02-24
112,48,32,15,23,230,10.965217391304348,2022-02-23
101,56,26,14,23,220,10.968181818181819,2022-02-22
120,50,34,14,23,241,10.564315352697095,2022-02-21
126,49,29,14,22,240,10.370833333333334,2022-02-20
115,52,27,15,21,230,10.456521739130435,2022-02-19
109,52,27,13,24,225,10.755555555555556,2022-02-18
109,52,27,12,22,222,10.211711711711711,2022-02-17
116,54,30,11,22,233,10.24892703862661,2022-02-16
123,55,27,13,20,238,9.84873949579832,2022-02-15
113,57,23,13,19,225,9.866666666666667,2022-02-14
108,54,22,14,18,216,10.166666666666666,2022-02-13
118,47,22,15,19,221,10.339366515837105,2022-02-12
114,46,25,17,17,219,9.858447488584474,2022-02-11
112,53,27,21,15,228,10.013157894736842,2022-02-10
109,52,28,20,15,224,10.205357142857142,2022-02-09
104,53,28,18,14,217,10.138248847926267,2022-02-08
101,54,30,19,12,216,9.805555555555555,2022-02-07
103,50,25,18,12,208,9.634615384615385,2022-02-06
95,54,23,16,13,201,9.960199004975124,2022-02-05
98,57,24,14,12,205,9.439024390243903,2022-02-04
108,51,26,13,10,208,9.163461538461538,2022-02-03
111,51,25,13,10,210,9.028571428571428,2022-02-02
120,48,24,13,9,214,8.546728971962617,2022-02-01
120,46,28,11,8,213,8.291079812206572,2022-01-31
119,39,29,12,5,204,7.980392156862745,2022-01-30
117,40,28,13,3,201,7.855721393034826,2022-01-29
117,44,21,15,1,198,7.44949494949495,2022-01-28
112,41,26,11,1,191,7.465968586387435,2022-01-27
109,46,21,10,2,188,7.382978723404255,2022-01-26
99,48,21,11,0,179,7.687150837988827,2022-01-25
104,53,19,10,1,187,7.390374331550802,2022-01-24
101,54,21,7,4,187,7.791443850267379,2022-01-23
104,54,23,6,4,191,7.853403141361256,2022-01-22
106,52,23,4,5,190,7.705263157894737,2022-01-21
107,56,16,3,5,187,7.278074866310161,2022-01-20
114,42,18,5,3,182,7.043956043956044,2022-01-19
114,38,18,2,3,175,6.714285714285714,2022-01-18
110,38,15,2,3,168,6.404761904761905,2022-01-17
109,41,10,4,3,167,6.293413173652695,2022-01-16
102,34,7,5,3,151,6.311258278145695,2022-01-15
99,37,8,6,3,153,6.503267973856209,2022-01-14
105,26,10,5,5,151,6.6158940397351,2022-01-13
90,29,14,5,8,146,7.773972602739726,2022-01-12
90,35,11,6,6,148,7.587837837837838,2022-01-11
88,32,10,7,6,143,7.4125874125874125,2022-01-10
113,28,7,6,5,159,6.628930817610063,2022-01-09
115,27,16,5,6,169,6.881656804733728,2022-01-08
107,19,17,6,10,159,7.886792452830188,2022-01-07
94,27,15,11,13,160,9.40625,2022-01-06
95,36,17,13,17,178,9.646067415730338,2022-01-05
91,37,17,11,17,173,9.855491329479769,2022-01-04
97,40,16,15,14,182,9.527472527472527,2022-01-03
86,36,14,21,10,167,10.281437125748504,2022-01-02
87,35,15,21,9,167,10.035928143712574,2022-01-01
80,36,13,21,8,158,9.99367088607595,2021-12-31
87,35,19,18,9,168,9.630952380952381,2021-12-30
90,34,18,16,10,168,9.345238095238095,2021-12-29
97,36,14,17,8,172,8.906976744186046,2021-12-28
88,36,17,15,7,163,9.006134969325153,2021-12-27
84,31,28,9,7,159,9.270440251572326,2021-12-26
83,33,26,8,5,155,8.96774193548387,2021-12-25
84,30,28,10,4,156,8.743589743589743,2021-12-24
81,34,28,8,5,156,8.826923076923077,2021-12-23
78,33,27,11,4,153,8.92156862745098,2021-12-22
79,34,30,10,4,157,9.0828025477707,2021-12-21
89,36,30,8,4,167,8.538922155688622,2021-12-20
89,45,19,10,3,166,8.283132530120483,2021-12-19
94,44,20,6,3,167,8.011976047904191,2021-12-18
91,45,21,6,1,164,7.5060975609756095,2021-12-17
97,50,16,6,4,173,7.872832369942197,2021-12-16
100,47,16,5,6,174,7.7701149425287355,2021-12-15
94,51,14,6,6,171,7.8654970760233915,2021-12-14
94,51,17,7,6,175,8.045714285714286,2021-12-13
109,37,18,5,7,176,7.755681818181818,2021-12-12
107,40,14,7,5,173,7.664739884393064,2021-12-11
112,37,14,7,4,174,6.971264367816092,2021-12-10
112,32,13,6,3,166,6.795180722891566,2021-12-09
108,27,17,6,3,161,6.826086956521739,2021-12-08
118,33,15,6,4,176,6.590909090909091,2021-12-07
112,28,13,10,5,168,7.148809523809524,2021-12-06
96,32,11,10,6,155,7.690322580645161,2021-12-05
102,33,17,8,7,167,7.796407185628743,2021-12-04
104,36,15,9,8,172,8.186046511627907,2021-12-03
94,38,19,6,9,166,8.44578313253012,2021-12-02
90,43,21,7,9,170,8.535294117647059,2021-12-01
96,40,19,9,6,170,8.33529411764706,2021-11-30
93,41,24,6,7,171,8.444444444444445,2021-11-29
102,34,22,8,5,171,7.994152046783626,2021-11-28
94,39,17,9,5,164,7.945121951219512,2021-11-27
93,34,16,7,6,156,7.9743589743589745,2021-11-26
88,44,17,11,7,167,8.784431137724551,2021-11-25
93,42,22,14,7,178,8.842696629213483,2021-11-24
85,40,25,10,9,169,9.355029585798816,2021-11-23
82,49,25,7,10,173,9.439306358381502,2021-11-22
80,46,27,8,9,170,9.588235294117647,2021-11-21
77,44,28,11,8,168,9.767857142857142,2021-11-20
81,44,23,11,8,167,9.48502994011976,2021-11-19
89,41,21,11,6,168,8.880952380952381,2021-11-18
85,41,26,9,7,168,8.863095238095237,2021-11-17
77,53,17,8,8,163,8.895705521472392,2021-11-16
92,48,20,8,8,176,8.721590909090908,2021-11-15
86,59,18,9,6,178,8.5561797752809,2021-11-14
93,51,22,9,4,179,8.1731843575419,2021-11-13
94,47,20,10,4,175,8.108571428571429,2021-11-12
102,47,19,12,4,184,8.277173913043478,2021-11-11
104,50,18,15,3,190,7.910526315789474,2021-11-10
116,42,23,14,3,198,7.611111111111111,2021-11-09
109,34,22,16,2,183,7.879781420765028,2021-11-08
110,38,21,12,2,183,7.530054644808743,2021-11-07
109,53,23,9,1,195,7.441025641025641,2021-11-06
107,53,26,14,4,204,8.259803921568627,2021-11-05
112,42,25,13,2,194,8.04639175257732,2021-11-04
115,45,32,7,3,202,7.836633663366337,2021-11-03
110,46,35,7,4,202,8.247524752475247,2021-11-02
111,45,39,7,7,209,8.688995215311005,2021-11-01
111,40,41,11,9,212,9.13679245283019,2021-10-31
120,47,35,6,8,216,8.555555555555555,2021-10-30
118,46,37,8,10,219,8.625570776255708,2021-10-29
116,53,36,8,10,223,8.856502242152466,2021-10-28
118,64,25,11,9,227,8.71806167400881,2021-10-27
111,69,25,10,9,224,8.647321428571429,2021-10-26
114,64,25,12,10,225,8.80888888888889,2021-10-25
107,69,29,13,12,230,9.139130434782608,2021-10-24
125,67,22,13,10,237,8.620253164556962,2021-10-23
127,63,24,13,8,235,8.153191489361703,2021-10-22
118,63,24,18,5,228,8.56578947368421,2021-10-21
130,52,27,16,5,230,8.217391304347826,2021-10-20
135,49,28,16,4,232,7.849137931034483,2021-10-19
131,45,29,15,5,225,7.977777777777778,2021-10-18
128,48,30,14,9,229,8.179039301310043,2021-10-17
117,46,31,13,7,214,8.523364485981308,2021-10-16
112,48,28,12,6,206,8.155339805825243,2021-10-15
105,48,27,10,6,196,8.576530612244898,2021-10-14
94,51,26,8,7,186,8.709677419354838,2021-10-13
90,50,27,9,7,183,8.94535519125683,2021-10-12
85,53,29,14,18,199,11.120603015075377,2021-10-11
90,47,30,16,21,204,11.392156862745098,2021-10-10
85,48,31,14,21,199,11.492462311557789,2021-10-09
84,50,33,16,24,207,11.966183574879228,2021-10-08
87,54,27,14,26,208,11.990384615384615,2021-10-07
86,65,33,13,28,225,12.20888888888889,2021-10-06
89,68,38,14,27,236,12.016949152542374,2021-10-05
97,72,38,14,26,247,11.522267206477732,2021-10-04
87,78,36,15,25,241,11.556016597510373,2021-10-03
94,77,28,16,24,239,11.158995815899582,2021-10-02
94,77,28,16,24,239,11.158995815899582,2021-10-01
101,67,22,25,18,233,10.832618025751072,2021-09-30
111,62,19,23,16,231,10.194805194805195,2021-09-29
106,64,28,25,14,237,10.59071729957806,2021-09-28
103,58,30,25,16,232,10.870689655172415,2021-09-27
104,64,32,26,14,240,10.366666666666667,2021-09-26
101,53,34,26,12,226,10.238938053097344,2021-09-25
93,58,42,24,8,225,10.502222222222223,2021-09-24
94,55,57,22,10,238,10.827731092436975,2021-09-23
105,42,60,28,12,247,11.878542510121457,2021-09-22
109,51,59,24,13,256,11.53125,2021-09-21
109,69,60,25,18,281,11.758007117437723,2021-09-20
111,69,60,24,21,285,11.764912280701754,2021-09-19
104,69,56,28,27,284,12.598591549295774,2021-09-18
107,80,47,24,28,286,12.178321678321678,2021-09-17
101,87,47,26,28,289,12.121107266435986,2021-09-16
98,75,49,22,26,270,12.537037037037036,2021-09-15
98,72,46,22,25,263,12.463878326996198,2021-09-14
102,70,42,22,27,263,12.49809885931559,2021-09-13
109,67,38,26,26,266,12.25563909774436,2021-09-12
112,66,35,22,27,262,11.86259541984733,2021-09-11
116,58,31,23,24,252,11.515873015873016,2021-09-10
120,55,33,19,26,253,11.193675889328063,2021-09-09
108,62,27,21,23,241,11.45643153526971,2021-09-08
103,59,30,17,23,232,11.538793103448276,2021-09-07
100,53,29,18,20,220,11.263636363636364,2021-09-06
118,64,24,10,3,219,7.579908675799087,2021-09-05
121,64,23,6,3,217,7.105990783410138,2021-09-04
126,54,24,16,2,222,7.887387387387387,2021-09-03
124,53,22,19,4,222,8.166666666666666,2021-09-02
133,47,27,16,7,230,8.560869565217391,2021-09-01
141,42,34,16,21,254,10.303149606299213,2021-08-31
146,44,30,13,20,253,9.671936758893281,2021-08-30
143,50,27,16,23,259,9.833976833976834,2021-08-29
142,54,24,18,20,258,9.356589147286822,2021-08-28
132,52,21,15,22,242,9.743801652892563,2021-08-27
140,50,25,12,24,251,9.54581673306773,2021-08-26
132,57,23,8,26,246,9.723577235772357,2021-08-25
144,69,22,12,28,275,10.218181818181819,2021-08-24
152,61,21,13,34,281,10.455516014234876,2021-08-23
159,48,24,20,26,277,10.090252707581227,2021-08-22
160,43,27,18,25,273,9.637362637362637,2021-08-21
149,51,28,19,26,273,9.945054945054945,2021-08-20
146,50,22,22,28,268,10.067164179104477,2021-08-19
134,52,17,24,39,266,11.522556390977444,2021-08-18
125,55,20,26,37,263,12.095057034220533,2021-08-17
120,54,20,27,42,263,12.634980988593156,2021-08-16
114,58,27,23,37,259,12.428571428571429,2021-08-15
114,65,23,28,34,264,12.242424242424242,2021-08-14
116,54,23,28,33,254,12.358267716535433,2021-08-13
121,42,27,25,32,247,11.894736842105264,2021-08-12
121,37,29,26,32,245,12.048979591836735,2021-08-11
121,34,29,25,29,238,11.760504201680673,2021-08-10
116,37,32,33,21,239,11.652719665271967,2021-08-09
120,37,27,31,22,237,11.69620253164557,2021-08-08
112,38,32,28,19,229,11.668122270742359,2021-08-07
98,37,37,28,22,222,12.518018018018019,2021-08-06
91,44,34,31,22,222,12.873873873873874,2021-08-05
74,49,37,27,23,210,13.123809523809523,2021-08-04
81,48,32,27,20,208,12.735576923076923,2021-08-03
88,55,43,23,19,228,12.43421052631579,2021-08-02
93,52,41,19,22,227,12.52863436123348,2021-08-01
92,55,41,20,20,228,12.473684210526315,2021-07-31
96,56,42,21,18,233,11.927038626609441,2021-07-30
104,52,46,19,18,239,11.472803347280335,2021-07-29
109,53,46,19,17,244,10.795081967213115,2021-07-28
112,46,41,17,17,233,10.630901287553648,2021-07-27
107,60,34,17,16,234,10.709401709401709,2021-07-26
103,57,30,21,15,226,11.075221238938052,2021-07-25
108,61,29,17,14,229,10.602620087336245,2021-07-24
105,76,29,14,14,238,10.100840336134453,2021-07-23
108,75,30,13,19,245,10.620408163265306,2021-07-22
112,68,28,13,17,238,10.121848739495798,2021-07-21
111,69,25,15,17,237,10.354430379746836,2021-07-20
125,62,27,18,15,247,10.368421052631579,2021-07-19
122,56,29,14,16,237,10.523206751054852,2021-07-18
138,42,27,15,14,236,10.072033898305085,2021-07-17
140,49,24,17,15,245,9.963265306122448,2021-07-16
145,44,22,17,15,243,9.530864197530864,2021-07-15
147,43,25,16,22,253,9.988142292490119,2021-07-14
148,38,26,14,23,249,10.068273092369479,2021-07-13
144,44,23,11,25,247,10.45344129554656,2021-07-12
138,42,20,11,23,234,10.26923076923077,2021-07-11
131,40,22,11,22,226,10.650442477876107,2021-07-10
136,34,23,9,23,225,10.364444444444445,2021-07-09
118,32,29,9,25,213,11.018779342723004,2021-07-08
121,35,30,14,29,229,11.541484716157205,2021-07-07
111,38,28,15,30,222,12.036036036036036,2021-07-06
106,44,27,13,30,220,15.763636363636364,2021-07-05
106,44,27,13,27,217,11.764976958525345,2021-07-04
107,35,29,13,27,211,12.056872037914692,2021-07-03
94,43,23,13,26,199,12.155778894472363,2021-07-02
103,45,27,13,33,221,12.2579185520362,2021-07-01
99,42,22,14,31,208,12.225961538461538,2021-06-30
106,51,23,15,27,222,11.5,2021-06-29
110,45,22,15,30,222,11.684684684684685,2021-06-28
119,42,19,14,31,225,11.715555555555556,2021-06-27
115,44,15,15,30,219,11.657534246575343,2021-06-26
138,35,15,15,29,232,10.689655172413794,2021-06-25
141,37,14,18,26,236,10.084745762711865,2021-06-24
148,30,17,15,27,237,9.915611814345992,2021-06-23
144,33,17,13,25,232,9.612068965517242,2021-06-22
149,38,17,20,19,243,9.415637860082304,2021-06-21
150,29,18,16,21,234,9.504273504273504,2021-06-20
154,25,19,17,18,233,9.103004291845494,2021-06-19
129,28,18,17,17,209,9.526315789473685,2021-06-18
134,23,21,15,16,209,9.004784688995215,2021-06-17
132,21,19,17,15,204,8.97549019607843,2021-06-16
136,22,18,19,13,208,8.98076923076923,2021-06-15
121,28,25,14,11,199,9.165829145728644,2021-06-14
113,27,22,15,10,187,9.272727272727273,2021-06-13
107,33,23,14,9,186,9.403225806451612,2021-06-12
112,32,21,14,9,188,9.02659574468085,2021-06-11
109,35,22,13,12,191,9.193717277486911,2021-06-10
110,34,22,12,13,191,9.24607329842932,2021-06-09
120,33,27,8,19,207,10.004830917874395,2021-06-08
123,46,23,6,20,218,9.68348623853211,2021-06-07
130,44,23,6,18,221,9.144796380090497,2021-06-06
135,37,24,5,16,217,8.7926267281106,2021-06-05
138,35,26,9,15,223,8.919282511210762,2021-06-04
140,34,30,10,14,228,8.710526315789474,2021-06-03
138,35,27,9,14,223,8.304932735426009,2021-06-02
119,53,14,13,14,213,8.906103286384976,2021-06-01
130,43,12,17,12,214,8.69158878504673,2021-05-31
128,38,14,15,12,207,8.502415458937199,2021-05-30
120,35,16,12,13,196,8.612244897959183,2021-05-29
118,42,20,11,14,205,9.165853658536586,2021-05-28
110,59,24,9,14,216,9.273148148148149,2021-05-27
116,62,23,12,17,230,9.486956521739131,2021-05-26
126,51,22,14,15,228,9.407894736842104,2021-05-25
115,50,21,11,16,213,9.39906103286385,2021-05-24
119,45,21,11,14,210,9.023809523809524,2021-05-23
123,45,15,13,13,209,8.578947368421053,2021-05-22
125,52,15,15,13,220,8.868181818181819,2021-05-21
144,48,14,20,9,235,8.353191489361702,2021-05-20
154,34,22,20,11,241,8.659751037344398,2021-05-19
140,50,31,24,19,264,10.280303030303031,2021-05-18
153,34,27,26,19,259,9.911196911196912,2021-05-17
147,42,31,25,19,264,10.022727272727273,2021-05-16
147,32,35,29,20,263,10.311787072243346,2021-05-15
144,34,35,28,23,264,10.643939393939394,2021-05-14
128,41,41,22,24,256,11.04296875,2021-05-13
109,44,49,16,22,240,11.433333333333334,2021-05-12
110,53,38,16,24,241,11.398340248962656,2021-05-11
105,54,45,19,22,245,11.816326530612244,2021-05-10
109,53,37,17,26,242,12.02892561983471,2021-05-09
112,49,38,14,26,239,11.828451882845188,2021-05-08
112,53,33,14,28,240,11.775,2021-05-07
123,64,28,12,28,255,10.937254901960785,2021-05-06
124,64,22,11,28,249,10.582329317269076,2021-05-05
137,43,23,11,26,240,10.091666666666667,2021-05-04
128,51,26,7,25,237,10.054852320675106,2021-05-03
129,42,26,7,24,228,9.907894736842104,2021-05-02
125,48,21,6,27,227,10.127753303964758,2021-05-01
127,45,20,6,32,230,10.5,2021-04-30
140,39,17,11,27,234,10.021367521367521,2021-04-29
141,34,15,14,26,230,10.02608695652174,2021-04-28
129,41,14,19,31,234,11.363247863247864,2021-04-27
136,53,13,19,35,256,11.27734375,2021-04-26
129,54,14,23,37,257,12.038910505836576,2021-04-25
151,35,13,22,47,268,12.578358208955224,2021-04-24
152,35,18,21,51,277,12.59927797833935,2021-04-23
130,37,18,15,57,257,13.789883268482491,2021-04-22
127,37,26,11,60,261,13.75095785440613,2021-04-21
125,41,29,9,58,262,13.34351145038168,2021-04-20
128,31,27,15,53,254,13.362204724409448,2021-04-19
127,29,32,20,48,256,13.1953125,2021-04-18
104,33,27,23,46,233,14.261802575107296,2021-04-17
97,38,25,26,49,235,14.680851063829786,2021-04-16
110,38,22,29,46,245,13.926530612244898,2021-04-15
113,37,18,41,34,243,13.366255144032921,2021-04-14
115,36,16,40,37,244,13.40983606557377,2021-04-13
112,36,21,36,36,241,13.390041493775934,2021-04-12
111,40,30,31,36,248,13.100806451612904,2021-04-11
105,41,30,33,32,241,13.024896265560166,2021-04-10
102,44,32,34,32,244,12.85655737704918,2021-04-09
110,33,35,35,29,242,12.727272727272727,2021-04-08
113,33,46,30,25,247,12.384615384615385,2021-04-07
120,28,44,28,25,245,12.012244897959183,2021-04-06
124,35,38,32,19,248,11.471774193548388,2021-04-05
132,37,33,31,17,250,10.78,2021-04-04
138,36,39,28,16,257,10.400778210116732,2021-04-03
134,49,38,25,15,261,9.88888888888889,2021-04-02
129,56,43,24,12,264,9.852272727272727,2021-04-01
124,61,35,22,13,255,9.858823529411765,2021-03-31
120,60,36,20,12,248,9.806451612903226,2021-03-30
128,52,40,13,11,244,9.307377049180328,2021-03-29
134,44,40,12,10,240,8.983333333333333,2021-03-28
134,46,36,13,7,236,8.597457627118644,2021-03-27
137,57,32,14,5,245,8.016326530612245,2021-03-26
139,56,32,9,4,240,7.591666666666667,2021-03-25
156,45,25,13,6,245,7.661224489795918,2021-03-24
151,42,28,11,5,237,7.468354430379747,2021-03-23
143,61,21,10,8,243,7.851851851851852,2021-03-22
129,62,24,8,9,232,8.064655172413794,2021-03-21
136,55,24,8,8,231,7.865800865800866,2021-03-20
142,55,24,6,8,235,7.472340425531915,2021-03-19
144,57,19,4,11,235,7.391489361702128,2021-03-18
135,49,18,5,10,217,7.539170506912442,2021-03-17
139,40,16,7,8,210,7.328571428571428,2021-03-16
154,42,13,6,9,224,6.933035714285714,2021-03-15
153,38,14,8,6,219,6.598173515981735,2021-03-14
153,34,12,10,4,213,6.52112676056338,2021-03-13
154,38,8,10,7,217,6.6728110599078345,2021-03-12
155,34,10,15,7,221,7.122171945701357,2021-03-11
143,35,14,10,8,210,7.319047619047619,2021-03-10
142,37,17,9,7,212,7.136792452830188,2021-03-09
134,31,18,9,8,200,7.495,2021-03-08
138,31,20,8,8,205,7.375609756097561,2021-03-07
131,32,18,7,9,197,7.456852791878172,2021-03-06
131,26,19,6,9,191,7.392670157068062,2021-03-05
124,27,20,6,14,191,8.387434554973822,2021-03-04
123,34,17,6,15,195,8.333333333333334,2021-03-03
125,30,15,11,15,196,8.612244897959183,2021-03-02
111,32,16,11,13,183,8.617486338797814,2021-03-01
108,36,16,11,10,181,8.453038674033149,2021-02-28
112,29,15,13,8,177,8.141242937853107,2021-02-27
108,30,19,12,9,178,8.764044943820224,2021-02-26
111,39,16,13,9,188,8.48936170212766,2021-02-25
125,38,21,16,10,210,8.938095238095238,2021-02-24
126,36,20,15,11,208,8.9375,2021-02-23
129,41,21,14,16,221,9.366515837104073,2021-02-22
134,41,20,11,16,222,8.95945945945946,2021-02-21
132,48,15,12,15,222,8.765765765765765,2021-02-20
130,49,16,10,15,220,8.590909090909092,2021-02-19
124,45,21,8,16,214,8.733644859813085,2021-02-18
121,45,27,8,18,219,9.287671232876713,2021-02-17
121,41,27,5,18,212,9.014150943396226,2021-02-16
129,37,31,6,16,219,8.812785388127853,2021-02-15
132,36,32,10,18,228,9.192982456140351,2021-02-14
130,33,34,13,16,226,9.389380530973451,2021-02-13
130,43,27,16,13,229,9.131004366812228,2021-02-12
131,54,23,24,24,256,11.4765625,2021-02-11
132,54,20,23,27,256,11.66796875,2021-02-10
126,58,16,28,26,254,11.704724409448819,2021-02-09
119,62,16,28,24,249,11.570281124497992,2021-02-08
112,57,22,33,22,246,12.06910569105691,2021-02-07
121,47,32,29,22,251,12.06772908366534,2021-02-06
127,44,32,25,23,251,11.685258964143426,2021-02-05
133,42,36,19,21,251,11.250996015936256,2021-02-04
130,41,31,19,25,246,11.947154471544716,2021-02-03
135,39,38,15,28,255,12.298039215686275,2021-02-02
135,42,41,10,28,256,11.984375,2021-02-01
125,47,41,8,26,247,11.793522267206479,2021-01-31
108,57,37,8,25,235,12.157446808510638,2021-01-30
107,51,33,12,26,229,12.729257641921397,2021-01-29
106,66,24,13,24,233,12.49785407725322,2021-01-28
108,60,22,15,23,228,12.302631578947368,2021-01-27
104,68,19,13,23,227,11.911894273127754,2021-01-26
118,65,12,14,25,234,11.94017094017094,2021-01-25
140,57,13,13,25,248,11.14516129032258,2021-01-24
146,50,16,11,28,251,11.02788844621514,2021-01-23
139,45,16,9,27,236,10.983050847457626,2021-01-22
141,35,17,7,26,226,10.730088495575222,2021-01-21
133,38,23,6,30,230,11.156521739130435,2021-01-20
133,32,21,9,27,222,10.77027027027027,2021-01-19
126,26,24,17,21,214,11.378504672897197,2021-01-18
111,34,19,17,20,201,11.711442786069652,2021-01-17
116,29,16,18,20,199,11.442211055276381,2021-01-16
113,35,12,19,18,197,11.274111675126903,2021-01-15
106,35,12,19,19,191,11.696335078534032,2021-01-14
104,35,13,24,21,197,12.152284263959391,2021-01-13
106,39,18,25,25,213,12.474178403755868,2021-01-12
98,37,30,13,25,203,13.0,2021-01-11
100,37,26,13,25,201,12.855721393034825,2021-01-10
90,32,27,16,22,187,13.165775401069519,2021-01-09
95,30,29,13,22,189,12.746031746031745,2021-01-08
99,25,27,17,23,191,13.172774869109947,2021-01-07
109,25,29,14,23,200,12.48,2021-01-06
112,28,34,13,24,211,12.336492890995261,2021-01-05
110,39,21,13,24,207,12.178743961352657,2021-01-04
112,36,21,13,24,206,12.087378640776699,2021-01-03
114,39,25,11,24,213,11.497652582159624,2021-01-02
106,45,20,11,22,204,11.387254901960784,2021-01-01
102,53,24,9,21,209,11.177033492822966,2020-12-31
96,52,22,9,20,199,11.381909547738694,2020-12-30
95,47,19,8,20,189,11.386243386243386,2020-12-29
113,34,16,9,19,191,10.780104712041885,2020-12-28
109,32,20,10,18,189,10.91005291005291,2020-12-27
112,35,19,11,17,194,10.505154639175258,2020-12-26
114,30,18,9,18,189,10.153439153439153,2020-12-25
115,36,11,11,17,190,10.121052631578948,2020-12-24
112,37,11,10,18,188,10.01595744680851,2020-12-23
109,35,12,11,17,184,9.994565217391305,2020-12-22
93,32,14,12,18,169,11.254437869822485,2020-12-21
95,32,14,9,19,169,10.923076923076923,2020-12-20
96,29,20,6,21,172,11.325581395348838,2020-12-19
106,24,20,6,25,181,11.408839779005525,2020-12-18
112,26,22,3,25,188,10.98936170212766,2020-12-17
116,33,18,5,25,197,10.472081218274111,2020-12-16
117,29,16,8,21,191,10.235602094240837,2020-12-15
116,31,14,11,20,192,10.510416666666666,2020-12-14
116,32,10,11,20,189,10.02116402116402,2020-12-13
111,31,7,12,19,180,9.966666666666667,2020-12-12
109,30,12,13,19,183,10.333333333333334,2020-12-11
100,29,10,14,21,174,11.258620689655173,2020-12-10
96,30,15,16,24,181,11.878453038674033,2020-12-09
90,27,21,11,22,171,12.058479532163743,2020-12-08
89,29,22,11,22,173,12.109826589595375,2020-12-07
100,36,23,14,22,195,11.964102564102564,2020-12-06
100,43,33,14,25,215,12.525581395348837,2020-12-05
102,37,33,15,23,210,12.657142857142857,2020-12-04
105,36,29,17,22,209,12.124401913875598,2020-12-03
102,42,25,17,25,211,12.14218009478673,2020-12-02
110,38,21,15,23,207,11.705314009661835,2020-12-01
115,42,21,12,28,218,11.646788990825687,2020-11-30
108,46,19,10,29,212,12.033018867924529,2020-11-29
102,45,16,12,27,202,12.024752475247524,2020-11-28
97,44,20,11,29,201,14.577114427860696,2020-11-27
97,42,23,14,34,210,15.114285714285714,2020-11-26
108,39,21,13,38,219,14.840182648401827,2020-11-25
101,37,19,13,40,210,15.647619047619047,2020-11-24
105,31,18,13,41,208,15.677884615384615,2020-11-23
106,34,18,19,38,215,15.655813953488373,2020-11-22
101,30,21,24,37,213,16.004694835680752,2020-11-21
99,33,21,26,36,215,14.227906976744187,2020-11-20
94,40,23,21,42,220,14.690909090909091,2020-11-19
102,37,20,22,40,221,14.239819004524886,2020-11-18
105,32,19,25,45,226,14.871681415929203,2020-11-17
106,42,28,24,46,246,14.731707317073171,2020-11-16
104,34,34,23,43,238,14.743697478991596,2020-11-15
106,40,39,25,44,254,14.645669291338583,2020-11-14
105,37,45,20,42,249,14.293172690763052,2020-11-13
113,41,39,20,41,254,13.681102362204724,2020-11-12
104,41,40,22,37,244,13.967213114754099,2020-11-11
100,45,34,23,34,236,13.805084745762711,2020-11-10
97,46,32,24,33,232,13.663793103448276,2020-11-09
89,51,31,19,32,222,13.545045045045045,2020-11-08
90,55,31,18,31,225,13.315555555555555,2020-11-07
89,62,24,19,29,223,13.170403587443946,2020-11-06
94,55,24,17,30,220,13.163636363636364,2020-11-05
92,59,26,12,29,218,12.793577981651376,2020-11-04
98,53,26,10,31,218,12.761467889908257,2020-11-03
101,54,29,13,30,227,12.51101321585903,2020-11-02
118,44,24,16,27,229,11.895196506550219,2020-11-01
119,45,22,21,26,233,11.858369098712446,2020-10-31
123,37,26,17,26,229,11.563318777292576,2020-10-30
121,32,26,16,25,220,11.454545454545455,2020-10-29
132,34,22,19,27,234,11.397435897435898,2020-10-28
120,39,24,23,23,229,11.7117903930131,2020-10-27
117,38,24,22,22,223,11.309417040358744,2020-10-26
107,35,30,19,22,213,11.657276995305164,2020-10-25
104,33,33,16,23,209,12.124401913875598,2020-10-24
105,39,25,16,22,207,11.830917874396135,2020-10-23
102,60,29,15,23,229,11.606986899563319,2020-10-22
93,57,26,12,23,211,11.872037914691942,2020-10-21
98,53,29,6,22,208,11.538461538461538,2020-10-20
107,62,28,5,23,225,10.751111111111111,2020-10-19
104,58,26,6,22,216,10.532407407407407,2020-10-18
103,58,25,5,21,212,10.14622641509434,2020-10-17
126,49,19,6,19,219,9.159817351598173,2020-10-16
125,40,18,8,16,207,9.246376811594203,2020-10-15
127,39,13,8,17,204,8.955882352941176,2020-10-14
119,47,8,7,18,199,9.015075376884422,2020-10-13
121,44,18,8,18,209,9.186602870813397,2020-10-12
121,45,14,7,19,206,9.490291262135923,2020-10-11
127,57,15,9,22,230,9.565217391304348,2020-10-10
135,38,16,11,22,222,10.243243243243244,2020-10-09
123,39,16,13,19,210,10.628571428571428,2020-10-08
126,36,14,16,19,211,10.597156398104266,2020-10-07
139,26,15,18,20,218,10.513761467889909,2020-10-06
129,29,16,25,20,219,10.931506849315069,2020-10-05
130,33,24,33,28,248,11.935483870967742,2020-10-04
126,46,34,32,38,276,12.80072463768116,2020-10-03
113,44,35,31,35,258,13.236434108527131,2020-10-02
112,45,37,36,26,256,13.06640625,2020-10-01
113,41,42,36,25,257,13.089494163424124,2020-09-30
105,52,49,31,22,259,13.015444015444016,2020-09-29
106,53,51,27,21,258,12.2984496124031,2020-09-28
111,45,52,26,20,254,11.913385826771654,2020-09-27
121,51,44,28,18,262,11.366412213740459,2020-09-26
117,53,42,29,16,257,11.334630350194553,2020-09-25
118,59,46,17,15,255,10.858823529411765,2020-09-24
122,59,44,18,14,257,10.778210116731518,2020-09-23
120,72,40,19,18,269,11.078066914498141,2020-09-22
121,80,36,20,17,274,10.704379562043796,2020-09-21
118,86,38,16,18,276,10.434782608695652,2020-09-20
127,67,38,13,17,262,10.374045801526718,2020-09-19
132,65,40,13,23,273,10.52014652014652,2020-09-18
139,75,26,14,25,279,10.559139784946236,2020-09-17
132,67,26,13,25,263,10.87832699619772,2020-09-16
150,54,27,16,21,268,10.369402985074627,2020-09-15
152,49,30,17,19,267,9.985018726591761,2020-09-14
147,51,29,17,17,261,9.758620689655173,2020-09-13
131,51,28,17,19,246,10.43089430894309,2020-09-12
130,51,21,19,17,238,10.121848739495798,2020-09-11
134,38,22,20,21,235,10.897872340425533,2020-09-10
136,35,23,19,27,240,11.4125,2020-09-09
119,42,31,13,27,232,11.693965517241379,2020-09-08
127,41,26,16,23,233,11.240343347639485,2020-09-07
138,39,25,14,29,245,11.448979591836734,2020-09-06
146,38,24,16,27,251,11.00796812749004,2020-09-05
147,34,30,20,30,261,11.452107279693486,2020-09-04
125,35,32,20,27,239,11.803347280334728,2020-09-03
117,40,32,23,25,237,11.810126582278482,2020-09-02
118,51,32,21,24,246,11.345528455284553,2020-09-01
117,60,32,22,23,254,11.598425196850394,2020-08-31
111,57,33,23,21,245,11.787755102040816,2020-08-30
103,55,28,21,20,227,11.960352422907489,2020-08-29
98,60,32,20,16,226,11.63716814159292,2020-08-28
103,58,33,20,16,230,11.3,2020-08-27
107,61,34,20,16,238,10.894957983193278,2020-08-26
114,54,31,17,15,231,10.415584415584416,2020-08-25
113,61,29,14,17,234,10.871794871794872,2020-08-24
111,64,32,10,20,237,11.071729957805907,2020-08-23
120,61,34,15,19,249,10.883534136546185,2020-08-22
124,59,34,14,17,248,10.455645161290322,2020-08-21
130,60,34,13,17,254,10.007874015748031,2020-08-20
135,55,30,9,18,247,9.558704453441296,2020-08-19
132,50,32,10,20,244,9.938524590163935,2020-08-18
141,47,24,11,16,239,9.623430962343097,2020-08-17
143,50,21,13,14,241,9.116182572614107,2020-08-16
134,48,26,10,15,233,9.377682403433477,2020-08-15
132,51,26,8,17,234,9.252136752136753,2020-08-14
141,55,23,11,15,245,8.946938775510205,2020-08-13
144,47,16,13,19,239,9.447698744769875,2020-08-12
142,42,21,12,20,237,9.375527426160337,2020-08-11
134,35,21,13,18,221,9.959276018099548,2020-08-10
133,39,31,14,14,231,9.796536796536797,2020-08-09
122,51,28,14,16,231,9.887445887445887,2020-08-08
116,48,26,15,17,222,10.031531531531531,2020-08-07
101,45,24,18,20,208,11.115384615384615,2020-08-06
98,40,23,16,20,197,11.218274111675127,2020-08-05
97,47,22,16,19,201,10.950248756218905,2020-08-04
94,53,24,12,17,200,10.945,2020-08-03
95,55,20,9,16,195,10.36923076923077,2020-08-02
111,42,22,12,19,206,10.402912621359222,2020-08-01
113,40,29,7,18,207,10.019323671497585,2020-07-31
113,45,26,7,17,208,9.625,2020-07-30
107,40,32,8,20,207,10.106280193236715,2020-07-29
108,38,30,10,20,206,10.412621359223301,2020-07-28
106,39,28,9,19,201,10.119402985074627,2020-07-27
110,44,23,10,16,203,9.58128078817734,2020-07-26
93,48,23,13,15,192,10.020833333333334,2020-07-25
91,53,12,15,12,183,9.863387978142077,2020-07-24
89,56,9,16,10,180,9.727777777777778,2020-07-23
99,51,10,17,10,187,9.32620320855615,2020-07-22
100,49,12,15,11,187,9.288770053475936,2020-07-21
104,38,12,15,8,177,8.94915254237288,2020-07-20
103,32,15,12,8,170,8.935294117647059,2020-07-19
109,30,18,11,8,176,8.255681818181818,2020-07-18
111,22,16,8,8,165,8.072727272727272,2020-07-17
112,22,20,5,8,167,7.904191616766467,2020-07-16
102,24,20,6,7,159,7.930817610062893,2020-07-15
100,30,17,8,6,161,7.962732919254658,2020-07-14
96,34,21,5,8,164,8.53048780487805,2020-07-13
94,37,15,6,8,160,8.44375,2020-07-12
99,38,15,7,12,171,8.608187134502923,2020-07-11
98,61,21,12,12,204,9.490196078431373,2020-07-10
96,65,20,14,10,205,9.526829268292683,2020-07-09
113,51,24,9,11,208,9.038461538461538,2020-07-08
117,49,22,8,10,206,8.70873786407767,2020-07-07
135,53,17,8,10,223,8.0,2020-07-06
149,40,18,10,10,227,7.797356828193832,2020-07-05
149,45,16,10,8,228,7.201754385964913,2020-07-04
150,40,18,9,6,223,6.668161434977579,2020-07-03
152,41,18,6,5,222,6.211711711711712,2020-07-02
129,37,13,7,4,190,6.589473684210526,2020-07-01
135,35,12,8,7,197,6.969543147208122,2020-06-30
129,35,13,8,9,194,7.443298969072165,2020-06-29
115,36,15,8,9,183,7.841530054644808,2020-06-28
118,30,13,8,7,176,7.392045454545454,2020-06-27
123,31,12,7,9,182,7.56043956043956,2020-06-26
118,31,10,8,10,177,7.745762711864407,2020-06-25
116,25,14,8,11,174,8.218390804597702,2020-06-24
112,24,13,9,12,170,8.505882352941176,2020-06-23
107,25,15,11,10,168,8.630952380952381,2020-06-22
107,26,16,8,10,167,8.335329341317365,2020-06-21
107,30,22,10,11,180,8.88888888888889,2020-06-20
112,28,20,10,12,182,8.945054945054945,2020-06-19
120,30,20,6,13,189,8.523809523809524,2020-06-18
122,39,22,12,9,204,8.661764705882353,2020-06-17
125,43,26,15,10,219,8.885844748858448,2020-06-16
123,48,30,10,11,222,8.63063063063063,2020-06-15
128,41,29,11,13,222,8.64864864864865,2020-06-14
125,40,31,9,14,219,8.73972602739726,2020-06-13
144,52,26,10,14,246,8.33739837398374,2020-06-12
152,44,22,13,11,242,8.206611570247935,2020-06-11
146,42,23,11,8,230,7.886956521739131,2020-06-10
150,39,22,12,9,232,7.702586206896552,2020-06-09
152,47,16,17,7,239,7.376569037656904,2020-06-08
147,43,18,13,7,228,7.0394736842105265,2020-06-07
137,51,19,18,4,229,7.205240174672489,2020-06-06
122,50,22,15,4,213,7.737089201877934,2020-06-05
140,43,26,13,3,225,7.062222222222222,2020-06-04
134,46,25,8,3,216,6.699074074074074,2020-06-03
125,40,25,8,3,201,6.746268656716418,2020-06-02
107,32,23,6,2,170,7.276470588235294,2020-06-01
102,38,23,9,2,174,7.609195402298851,2020-05-31
118,31,27,7,0,183,7.005464480874317,2020-05-30
110,33,23,7,0,173,7.011560693641618,2020-05-29
110,39,22,7,0,178,6.876404494382022,2020-05-28
113,41,16,14,1,185,7.124324324324324,2020-05-27
107,36,19,15,1,178,7.207865168539326,2020-05-26
101,37,26,8,5,177,8.124293785310735,2020-05-25
101,41,27,7,4,180,7.816666666666666,2020-05-24
94,42,26,4,4,170,7.970588235294118,2020-05-23
102,51,30,6,7,196,10.403061224489797,2020-05-22
109,46,27,6,8,196,10.346938775510203,2020-05-21
112,43,28,9,6,198,10.035353535353535,2020-05-20
110,50,27,11,6,204,9.818627450980392,2020-05-19
110,47,21,9,6,193,9.766839378238341,2020-05-18
113,46,21,10,4,194,9.396907216494846,2020-05-17
121,52,16,11,3,203,9.073891625615763,2020-05-16
119,52,17,10,3,201,7.437810945273632,2020-05-15
112,50,17,10,3,192,7.567708333333333,2020-05-14
110,52,19,8,5,194,7.72680412371134,2020-05-13
114,50,23,8,4,199,7.50251256281407,2020-05-12
121,42,21,10,5,199,7.663316582914573,2020-05-11
120,43,25,5,9,202,8.069306930693068,2020-05-10
128,40,25,6,9,208,8.29326923076923,2020-05-09
126,42,20,6,9,203,8.187192118226601,2020-05-08
128,39,20,8,9,204,7.9411764705882355,2020-05-07
128,44,20,7,9,208,7.668269230769231,2020-05-06
122,45,21,6,9,203,7.45320197044335,2020-05-05
117,43,20,4,9,193,7.414507772020725,2020-05-04
115,51,15,7,11,199,7.778894472361809,2020-05-03
114,46,24,10,7,201,8.373134328358208,2020-05-02
113,37,22,11,7,190,8.505263157894737,2020-05-01
104,45,16,12,8,185,8.545945945945945,2020-04-30
106,50,14,12,5,187,8.213903743315509,2020-04-29
109,47,15,12,5,188,7.829787234042553,2020-04-28
111,58,12,13,7,201,8.104477611940299,2020-04-27
114,49,20,15,10,208,8.870192307692308,2020-04-26
110,48,25,13,12,208,9.5625,2020-04-25
109,44,25,12,12,202,9.569306930693068,2020-04-24
124,34,25,11,12,206,8.800970873786408,2020-04-23
132,35,22,8,11,208,8.413461538461538,2020-04-22
139,31,23,9,9,211,7.815165876777251,2020-04-21
140,27,19,9,9,204,7.485294117647059,2020-04-20
132,25,17,11,8,193,7.430051813471502,2020-04-19
124,52,26,12,14,228,9.192982456140351,2020-04-18
131,49,25,10,13,228,8.635964912280702,2020-04-17
117,47,26,11,12,213,8.699530516431924,2020-04-16
106,47,23,12,11,199,9.140703517587939,2020-04-15
90,53,25,12,12,192,9.739583333333334,2020-04-14
89,45,28,11,19,192,11.020833333333334,2020-04-13
87,45,31,13,24,200,11.73,2020-04-12
87,50,26,13,25,201,11.721393034825871,2020-04-11
89,50,28,21,31,219,12.780821917808218,2020-04-10
97,46,34,16,30,223,12.179372197309418,2020-04-09
95,46,32,17,30,220,12.25,2020-04-08
100,46,30,24,25,225,11.724444444444444,2020-04-07
96,46,37,31,24,234,12.290598290598291,2020-04-06
95,53,37,30,23,238,12.004201680672269,2020-04-05
101,50,41,27,24,243,11.979423868312757,2020-04-04
99,47,37,25,22,230,11.782608695652174,2020-04-03
95,53,33,25,21,227,11.713656387665198,2020-04-02
92,51,35,25,20,223,12.004484304932735,2020-04-01
96,42,40,23,17,218,11.669724770642201,2020-03-31
91,47,41,23,15,217,11.68663594470046,2020-03-30
95,52,38,22,17,224,11.428571428571429,2020-03-29
95,55,31,23,13,217,10.976958525345623,2020-03-28
92,47,29,21,11,200,10.82,2020-03-27
97,49,29,23,8,206,10.29126213592233,2020-03-26
97,49,31,20,10,207,10.541062801932368,2020-03-25
88,57,30,16,11,202,10.569306930693068,2020-03-24
99,50,33,14,12,208,10.346153846153847,2020-03-23
94,43,31,15,11,194,10.27319587628866,2020-03-22
96,40,33,10,11,190,9.963157894736842,2020-03-21
94,49,39,8,9,199,9.793969849246231,2020-03-20
95,51,38,6,8,198,9.368686868686869,2020-03-19
93,68,27,7,7,202,9.049504950495049,2020-03-18
127,49,27,8,5,216,8.453703703703704,2020-03-17
111,50,23,7,5,196,8.494897959183673,2020-03-16
108,49,24,8,3,192,8.072916666666666,2020-03-15
101,52,21,9,5,188,8.574468085106384,2020-03-14
105,51,18,6,5,185,7.918918918918919,2020-03-13
103,54,15,5,6,183,7.983606557377049,2020-03-12
119,39,16,4,7,185,7.767567567567568,2020-03-11
87,41,16,2,7,153,9.143790849673202,2020-03-10
93,39,15,2,7,156,8.596153846153847,2020-03-09
96,40,13,0,7,156,7.92948717948718,2020-03-08
103,36,13,0,8,160,7.5625,2020-03-07
107,35,12,0,9,163,7.595092024539877,2020-03-06
103,27,14,2,9,155,7.95483870967742,2020-03-05
94,35,11,1,9,150,8.106666666666667,2020-03-04
91,35,5,0,9,140,7.835714285714285,2020-03-03
92,28,6,0,11,137,8.16058394160584,2020-03-02
90,31,13,2,14,150,8.94,2020-03-01
80,34,9,4,13,140,8.985714285714286,2020-02-29
81,30,9,5,12,137,9.124087591240876,2020-02-28
75,29,7,8,12,131,9.694656488549619,2020-02-27
75,28,7,7,12,129,9.635658914728682,2020-02-26
84,24,9,10,12,139,10.02158273381295,2020-02-25
77,26,8,10,13,134,10.171641791044776,2020-02-24
80,24,7,12,15,138,10.369565217391305,2020-02-23
83,21,10,10,17,141,10.21985815602837,2020-02-22
84,21,11,10,16,142,10.161971830985916,2020-02-21
82,18,16,8,18,142,10.359154929577464,2020-02-20
79,18,17,8,16,138,10.23913043478261,2020-02-19
73,13,19,8,16,129,10.992248062015504,2020-02-18
80,18,18,8,16,140,10.385714285714286,2020-02-17
75,18,20,13,20,146,12.061643835616438,2020-02-16
76,25,18,14,18,151,11.3841059602649,2020-02-15
77,28,17,15,17,154,11.487012987012987,2020-02-14
78,39,15,15,18,165,11.206060606060607,2020-02-13
82,51,16,16,16,181,10.662983425414364,2020-02-12
83,62,28,26,16,215,11.6,2020-02-11
90,58,22,25,16,211,11.156398104265403,2020-02-10
92,57,26,19,14,208,10.58173076923077,2020-02-09
96,48,30,16,12,202,10.03960396039604,2020-02-08
97,41,36,15,10,199,10.035175879396984,2020-02-07
105,34,34,15,9,197,9.527918781725889,2020-02-06
106,39,29,13,9,196,9.010204081632653,2020-02-05
102,37,29,11,9,188,9.122340425531915,2020-02-04
102,32,31,12,7,184,9.005434782608695,2020-02-03
104,38,23,11,6,182,8.478021978021978,2020-02-02
105,41,22,11,5,184,8.266304347826088,2020-02-01
99,52,19,8,5,183,8.021857923497267,2020-01-31
92,51,18,8,5,174,8.068965517241379,2020-01-30
94,41,17,9,4,165,7.781818181818182,2020-01-29
101,48,16,8,6,179,8.011173184357542,2020-01-28
90,54,20,8,5,177,8.254237288135593,2020-01-27
98,46,20,12,8,184,8.73913043478261,2020-01-26
98,40,20,14,4,176,8.522727272727273,2020-01-25
105,41,17,13,3,179,7.988826815642458,2020-01-24
104,38,18,14,2,176,7.6477272727272725,2020-01-23
100,43,25,12,2,182,7.824175824175824,2020-01-22
102,44,29,13,1,189,8.238095238095237,2020-01-21
108,52,24,11,1,196,7.627551020408164,2020-01-20
102,49,25,10,1,187,7.748663101604278,2020-01-19
102,53,24,7,2,188,7.723404255319149,2020-01-18
103,57,22,8,3,193,8.181347150259068,2020-01-17
104,50,21,6,3,184,7.657608695652174,2020-01-16
96,54,18,6,3,177,7.440677966101695,2020-01-15
88,47,19,4,2,160,7.11875,2020-01-14
92,46,18,4,2,162,7.037037037037037,2020-01-13
99,48,14,4,3,168,6.916666666666667,2020-01-12
101,42,11,3,3,160,6.74375,2020-01-11
101,28,10,2,3,144,6.534722222222222,2020-01-10
104,27,13,3,5,152,6.907894736842105,2020-01-09
113,25,11,3,5,157,6.3312101910828025,2020-01-08
116,43,10,5,7,181,7.082872928176796,2020-01-07
107,48,10,6,7,178,7.224719101123595,2020-01-06
99,38,11,5,7,160,7.175,2020-01-05
98,28,8,8,7,149,7.5369127516778525,2020-01-04
93,23,9,8,4,137,7.226277372262774,2020-01-03
86,30,16,8,4,144,7.618055555555555,2020-01-02
84,38,17,9,4,152,8.25,2020-01-01
90,27,16,7,4,144,7.993055555555555,2019-12-31
98,26,11,9,4,148,7.587837837837838,2019-12-30
94,42,16,11,4,167,8.1437125748503,2019-12-29
98,39,20,9,7,173,8.722543352601155,2019-12-28
92,42,20,5,7,166,8.337349397590362,2019-12-27
98,38,20,6,5,167,7.796407185628743,2019-12-26
103,34,17,5,5,164,7.469512195121951,2019-12-25
96,47,19,5,7,174,8.206896551724139,2019-12-24
101,38,21,4,6,170,8.064705882352941,2019-12-23
101,33,21,3,6,164,7.713414634146342,2019-12-22
93,34,19,3,6,155,7.8,2019-12-21
99,35,15,3,6,158,7.253164556962025,2019-12-20
97,39,14,2,5,157,7.050955414012739,2019-12-19
90,38,13,4,5,150,7.426666666666667,2019-12-18
93,41,11,3,5,153,7.189542483660131,2019-12-17
87,51,9,3,6,156,7.782051282051282,2019-12-16
89,46,8,4,5,152,7.401315789473684,2019-12-15
93,59,11,7,7,177,7.762711864406779,2019-12-14
102,42,14,6,6,170,7.3882352941176475,2019-12-13
107,32,9,6,4,158,6.7025316455696204,2019-12-12
108,37,11,9,2,167,6.634730538922156,2019-12-11
109,40,11,10,2,172,6.726744186046512,2019-12-10
120,33,14,9,1,177,6.677966101694915,2019-12-09
116,31,14,7,1,169,6.3017751479289945,2019-12-08
111,42,14,7,0,174,6.103448275862069,2019-12-07
99,57,16,5,1,178,6.365168539325842,2019-12-06
109,35,17,4,1,166,6.259036144578313,2019-12-05
115,35,21,5,0,176,6.6477272727272725,2019-12-04
109,30,25,4,0,168,6.7023809523809526,2019-12-03
90,37,25,4,0,156,7.25,2019-12-02
93,41,22,5,0,161,6.900621118012422,2019-12-01
97,44,21,5,0,167,6.634730538922156,2019-11-30
105,40,17,4,0,166,5.9879518072289155,2019-11-29
87,42,17,2,0,148,6.425675675675675,2019-11-28
89,40,13,0,0,142,6.563380281690141,2019-11-27
85,49,19,0,0,153,6.9869281045751634,2019-11-26
91,53,21,0,0,165,6.8121212121212125,2019-11-25
94,46,22,0,0,162,6.3580246913580245,2019-11-24
98,42,23,1,0,164,6.353658536585366,2019-11-23
93,49,18,0,0,160,6.1375,2019-11-22
103,42,13,0,0,158,5.7405063291139244,2019-11-21
99,48,6,0,0,153,5.915032679738562,2019-11-20
105,50,2,1,0,158,5.525316455696203,2019-11-19
106,49,6,2,0,163,5.723926380368098,2019-11-18
102,49,6,2,0,159,5.333333333333333,2019-11-17
98,44,6,1,1,150,5.1866666666666665,2019-11-16
110,31,5,1,1,148,4.837837837837838,2019-11-15
108,26,3,2,1,140,4.864285714285714,2019-11-14
125,14,0,2,1,142,4.007042253521127,2019-11-13
108,19,4,3,1,135,5.148148148148148,2019-11-12
107,21,6,1,1,136,4.9411764705882355,2019-11-11
130,20,2,1,1,154,4.01948051948052,2019-11-10
129,22,4,1,1,157,3.8917197452229297,2019-11-09
121,15,9,1,1,147,4.428571428571429,2019-11-08
117,10,8,1,2,138,4.601449275362318,2019-11-07
109,17,12,2,1,141,5.319148936170213,2019-11-06
107,25,11,2,1,146,5.527397260273973,2019-11-05
108,26,9,2,1,146,5.404109589041096,2019-11-04
96,26,10,2,1,135,5.533333333333333,2019-11-03
94,20,9,1,1,125,5.04,2019-11-02
91,36,11,1,2,141,5.971631205673759,2019-11-01
95,45,5,1,1,147,5.884353741496598,2019-10-31
94,52,9,1,2,158,6.462025316455696,2019-10-30
106,36,8,3,1,154,6.064935064935065,2019-10-29
109,38,5,4,1,157,5.885350318471337,2019-10-28
117,27,7,2,1,154,5.3896103896103895,2019-10-27
117,29,6,2,1,155,4.812903225806451,2019-10-26
114,24,8,1,1,148,4.824324324324325,2019-10-25
106,19,9,1,1,136,4.8088235294117645,2019-10-24
108,27,10,1,0,146,4.7534246575342465,2019-10-23
99,23,9,0,0,131,4.9541984732824424,2019-10-22
99,24,8,0,0,131,5.00763358778626,2019-10-21
96,19,5,1,0,121,5.033057851239669,2019-10-20
101,23,5,1,0,130,4.753846153846154,2019-10-19
95,28,4,2,0,129,4.829457364341085,2019-10-18
93,22,5,3,0,123,4.829268292682927,2019-10-17
100,19,5,3,1,128,5.1328125,2019-10-16
100,27,14,5,7,153,7.758169934640523,2019-10-15
94,29,12,4,8,147,8.013605442176871,2019-10-14
96,29,14,4,11,154,8.733766233766234,2019-10-13
93,30,17,7,9,156,8.717948717948717,2019-10-12
96,28,15,6,10,155,8.509677419354839,2019-10-11
95,25,12,6,11,149,8.63758389261745,2019-10-10
83,26,14,7,13,143,9.909090909090908,2019-10-09
76,35,15,8,16,150,10.76,2019-10-08
76,42,12,9,16,155,10.541935483870967,2019-10-07
78,33,9,10,15,145,10.751724137931035,2019-10-06
79,28,11,8,15,141,10.375886524822695,2019-10-05
75,35,11,8,15,144,10.083333333333334,2019-10-04
74,30,10,7,15,136,10.051470588235293,2019-10-03
79,29,16,4,16,144,9.944444444444445,2019-10-02
79,28,16,4,18,145,10.26206896551724,2019-10-01
83,28,14,5,19,149,10.174496644295303,2019-09-30
78,27,14,7,22,148,11.29054054054054,2019-09-29
72,30,20,9,20,151,11.549668874172186,2019-09-28
76,26,19,9,20,150,11.026666666666667,2019-09-27
75,29,18,9,21,152,10.953947368421053,2019-09-26
73,28,13,11,17,142,10.73943661971831,2019-09-25
75,30,10,10,18,143,10.335664335664335,2019-09-24
72,27,13,12,15,139,10.647482014388489,2019-09-23
71,27,15,18,11,142,10.76056338028169,2019-09-22
78,31,13,20,7,149,9.89261744966443,2019-09-21
75,29,14,20,11,149,10.416107382550335,2019-09-20
76,27,12,25,10,150,10.633333333333333,2019-09-19
74,30,13,21,11,149,10.48993288590604,2019-09-18
71,25,14,20,11,141,10.382978723404255,2019-09-17
72,21,16,19,8,136,10.25,2019-09-16
65,22,24,15,7,133,10.488721804511279,2019-09-15
76,21,26,10,8,141,9.794326241134751,2019-09-14
74,22,29,12,9,146,10.075342465753424,2019-09-13
65,33,34,12,11,155,10.838709677419354,2019-09-12
72,34,36,15,8,165,10.593939393939394,2019-09-11
66,42,36,19,8,171,10.824561403508772,2019-09-10
78,41,35,16,5,175,10.262857142857143,2019-09-09
79,60,29,12,5,185,9.632432432432433,2019-09-08
78,60,31,13,4,186,9.887096774193548,2019-09-07
81,59,40,12,2,194,9.45360824742268,2019-09-06
88,69,36,14,1,208,9.014423076923077,2019-09-05
82,67,31,12,0,192,8.786458333333334,2019-09-04
86,68,28,10,0,192,8.135416666666666,2019-09-03
82,67,22,7,0,178,8.084269662921349,2019-09-02
100,51,19,6,0,176,7.3125,2019-09-01
91,51,19,6,0,167,7.449101796407185,2019-08-31
92,60,16,7,1,176,7.3522727272727275,2019-08-30
107,45,18,7,2,179,7.100558659217877,2019-08-29
112,47,18,6,2,185,6.870270270270271,2019-08-28
119,44,22,8,5,198,7.444444444444445,2019-08-27
123,37,19,7,5,191,7.340314136125654,2019-08-26
114,47,23,9,7,200,8.225,2019-08-25
114,46,25,9,4,198,7.742424242424242,2019-08-24
114,42,28,9,5,198,7.712121212121212,2019-08-23
96,42,28,9,4,179,8.083798882681565,2019-08-22
101,47,26,7,5,186,8.091397849462366,2019-08-21
93,40,23,9,3,168,8.005952380952381,2019-08-20
94,39,22,9,4,168,12.446428571428571,2019-08-19
96,46,22,11,3,178,12.230337078651685,2019-08-18
98,48,23,9,2,180,12.0,2019-08-17
97,50,20,8,2,177,11.666666666666666,2019-08-16
101,45,19,6,1,172,7.017441860465116,2019-08-15
98,53,16,7,2,176,7.465909090909091,2019-08-14
101,65,19,6,4,195,11.97948717948718,2019-08-13
100,63,16,6,4,189,11.97883597883598,2019-08-12
116,46,20,5,4,191,11.921465968586388,2019-08-11
123,45,22,3,7,200,11.94,2019-08-10
123,49,19,5,6,202,11.55940594059406,2019-08-09
127,51,19,4,6,207,11.16425120772947,2019-08-08
130,51,18,5,5,209,10.794258373205741,2019-08-07
137,44,14,4,4,203,10.399014778325123,2019-08-06
132,38,10,3,5,188,10.606382978723405,2019-08-05
109,37,7,4,6,163,11.92638036809816,2019-08-04
108,34,7,4,6,159,11.968553459119496,2019-08-03
104,45,17,4,6,176,12.090909090909092,2019-08-02
94,56,15,6,6,177,7.796610169491525,2019-08-01
93,55,14,4,6,172,7.569767441860465,2019-07-31
91,44,12,3,6,156,7.871794871794871,2019-07-30
89,45,15,3,6,158,7.949367088607595,2019-07-29
92,42,15,3,5,157,7.54140127388535,2019-07-28
85,39,16,4,5,149,7.6375838926174495,2019-07-27
81,45,14,4,5,149,7.315436241610739,2019-07-26
100,31,16,4,5,156,7.038461538461538,2019-07-25
93,37,11,4,4,149,6.885906040268456,2019-07-24
92,29,10,2,5,138,7.007246376811594,2019-07-23
89,30,8,3,6,136,7.1838235294117645,2019-07-22
92,33,13,4,7,149,7.8389261744966445,2019-07-21
93,32,19,7,6,157,7.961783439490445,2019-07-20
97,33,18,7,5,160,7.39375,2019-07-19
84,34,15,7,5,145,7.8,2019-07-18
95,38,18,8,5,164,7.682926829268292,2019-07-17
95,35,17,8,3,158,7.7974683544303796,2019-07-16
90,37,17,6,4,154,8.064935064935066,2019-07-15
92,31,17,5,4,149,7.597315436241611,2019-07-14
89,33,15,6,3,146,7.232876712328767,2019-07-13
88,32,13,5,3,141,6.865248226950355,2019-07-12
87,30,17,4,5,143,7.426573426573427,2019-07-11
84,28,16,4,7,139,7.784172661870503,2019-07-10
82,22,14,3,9,130,8.376923076923077,2019-07-09
90,35,22,9,18,174,10.60344827586207,2019-07-08
86,34,22,9,18,169,10.609467455621301,2019-07-07
88,39,22,10,17,176,10.363636363636363,2019-07-06
87,41,25,12,17,182,10.31868131868132,2019-07-05
80,42,30,16,20,188,11.47340425531915,2019-07-04
85,39,29,18,17,188,11.180851063829786,2019-07-03
82,34,26,16,17,175,11.257142857142858,2019-07-02
82,31,20,21,13,167,11.317365269461078,2019-07-01
73,34,20,19,13,159,11.10691823899371,2019-06-30
76,29,26,17,12,160,10.89375,2019-06-29
75,31,27,20,10,163,10.760736196319018,2019-06-28
82,47,22,20,8,179,10.100558659217876,2019-06-27
75,45,26,18,7,171,10.251461988304094,2019-06-26
80,44,27,20,7,178,10.275280898876405,2019-06-25
82,49,39,20,15,205,11.678048780487805,2019-06-24
89,45,40,22,14,210,11.185714285714285,2019-06-23
86,50,41,17,12,206,10.674757281553399,2019-06-22
92,52,42,17,9,212,10.212264150943396,2019-06-21
96,51,41,13,9,210,9.861904761904762,2019-06-20
94,55,33,16,5,203,9.448275862068966,2019-06-19
85,60,38,21,5,209,10.0,2019-06-18
79,65,33,22,8,207,10.545893719806763,2019-06-17
78,57,35,20,6,196,10.260204081632653,2019-06-16
80,58,28,18,5,189,9.682539682539682,2019-06-15
81,66,27,15,6,195,9.543589743589743,2019-06-14
80,58,25,15,5,183,9.480874316939891,2019-06-13
88,52,26,12,3,181,8.861878453038674,2019-06-12
86,53,31,11,1,182,8.626373626373626,2019-06-11
94,54,29,10,1,188,8.28191489361702,2019-06-10
93,52,31,7,1,184,8.048913043478262,2019-06-09
101,44,33,6,1,185,7.827027027027027,2019-06-08
106,43,30,6,0,185,7.45945945945946,2019-06-07
108,41,30,5,0,184,7.048913043478261,2019-06-06
102,43,25,3,0,173,6.803468208092486,2019-06-05
101,53,17,2,0,173,6.364161849710983,2019-06-04
90,55,16,0,0,161,6.372670807453416,2019-06-03
91,54,11,0,0,156,6.083333333333333,2019-06-02
85,46,9,1,0,141,5.9787234042553195,2019-06-01
82,46,12,1,0,141,6.198581560283688,2019-05-31
77,46,11,1,0,135,6.014814814814815,2019-05-30
87,34,9,1,0,131,5.564885496183206,2019-05-29
99,31,5,2,0,137,5.437956204379562,2019-05-28
103,32,3,2,0,140,5.142857142857143,2019-05-27
113,22,4,1,0,140,5.007142857142857,2019-05-26
105,27,5,1,0,138,4.782608695652174,2019-05-25
101,28,4,1,0,134,4.619402985074627,2019-05-24
100,37,4,1,0,142,4.5,2019-05-23
96,27,7,0,0,130,4.346153846153846,2019-05-22
97,24,7,0,0,128,4.7109375,2019-05-21
99,24,8,0,0,131,4.984732824427481,2019-05-20
93,23,7,0,0,123,5.211382113821138,2019-05-19
94,21,6,0,0,121,4.628099173553719,2019-05-18
95,24,2,0,0,121,4.380165289256198,2019-05-17
101,18,4,0,0,123,4.154471544715447,2019-05-16
97,18,0,0,0,115,3.6869565217391305,2019-05-15
84,18,2,0,0,104,4.096153846153846,2019-05-14
79,13,4,1,0,97,4.639175257731959,2019-05-13
76,14,12,2,0,104,5.865384615384615,2019-05-12
79,20,13,4,0,116,6.103448275862069,2019-05-11
83,22,13,3,0,121,6.223140495867769,2019-05-10
82,22,12,2,0,118,6.237288135593221,2019-05-09
89,28,12,4,2,135,6.866666666666666,2019-05-08
94,25,13,8,3,143,7.2727272727272725,2019-05-07
90,34,14,8,5,151,7.76158940397351,2019-05-06
96,30,16,9,6,157,7.949044585987261,2019-05-05
93,35,19,9,6,162,8.117283950617283,2019-05-04
91,39,20,10,7,167,8.461077844311378,2019-05-03
88,39,23,5,7,162,8.358024691358025,2019-05-02
85,39,23,5,7,159,8.584905660377359,2019-05-01
83,39,26,4,6,158,8.373417721518987,2019-04-30
83,39,21,6,5,154,8.357142857142858,2019-04-29
79,36,18,8,8,149,8.986577181208053,2019-04-28
79,36,21,9,12,157,9.573248407643312,2019-04-27
80,37,23,14,9,163,9.656441717791411,2019-04-26
83,38,21,16,8,166,9.506024096385541,2019-04-25
83,44,22,12,7,168,9.261904761904763,2019-04-24
88,38,18,12,7,163,8.94478527607362,2019-04-23
88,33,19,11,5,156,8.679487179487179,2019-04-22
83,33,16,12,5,149,8.731543624161073,2019-04-21
78,33,16,13,4,144,8.347222222222221,2019-04-20
78,35,18,11,4,146,8.308219178082192,2019-04-19
78,33,22,14,3,150,8.72,2019-04-18
79,35,21,14,3,152,8.802631578947368,2019-04-17
86,28,29,11,3,157,8.898089171974522,2019-04-16
81,46,27,10,3,167,9.263473053892216,2019-04-15
82,45,26,9,3,165,8.824242424242424,2019-04-14
84,48,27,9,3,171,8.450292397660819,2019-04-13
86,48,26,8,2,170,8.18235294117647,2019-04-12
91,47,24,9,3,174,8.270114942528735,2019-04-11
97,46,25,12,5,185,8.778378378378378,2019-04-10
83,61,25,10,5,184,9.076086956521738,2019-04-09
99,52,24,9,6,190,8.763157894736842,2019-04-08
98,53,25,6,5,187,8.251336898395722,2019-04-07
98,49,22,7,4,180,7.9,2019-04-06
97,49,19,6,4,175,7.405714285714286,2019-04-05
101,44,20,6,6,177,7.728813559322034,2019-04-04
97,38,22,4,5,166,7.566265060240964,2019-04-03
107,36,17,6,3,169,7.0828402366863905,2019-04-02
96,39,15,7,3,160,7.36875,2019-04-01
96,39,11,6,3,155,6.819354838709677,2019-03-31
96,36,10,6,2,150,6.453333333333333,2019-03-30
94,32,13,6,3,148,6.506756756756757,2019-03-29
86,28,14,7,1,136,6.713235294117647,2019-03-28
84,33,13,5,1,136,6.654411764705882,2019-03-27
80,34,17,4,1,136,7.3161764705882355,2019-03-26
81,38,18,6,0,143,7.363636363636363,2019-03-25
93,34,18,7,0,152,7.105263157894737,2019-03-24
97,31,17,6,1,152,7.0394736842105265,2019-03-23
94,35,16,10,0,155,7.129032258064516,2019-03-22
87,39,17,8,0,151,7.066225165562914,2019-03-21
90,39,19,5,0,153,6.9869281045751634,2019-03-20
92,42,18,3,0,155,6.619354838709677,2019-03-19
95,36,17,1,0,149,6.268456375838926,2019-03-18
83,37,13,2,1,136,6.477941176470588,2019-03-17
79,36,14,1,1,131,6.633587786259542,2019-03-16
88,33,12,0,1,134,6.164179104477612,2019-03-15
92,37,11,2,2,144,6.145833333333333,2019-03-14
95,40,8,3,2,148,6.0675675675675675,2019-03-13
93,40,9,4,1,147,6.170068027210885,2019-03-12
88,32,7,5,0,132,6.106060606060606,2019-03-11
89,31,7,5,0,132,5.878787878787879,2019-03-10
87,27,5,4,0,123,5.439024390243903,2019-03-09
83,24,2,5,0,114,5.385964912280702,2019-03-08
84,19,6,4,0,113,5.31858407079646,2019-03-07
82,20,6,2,0,110,5.090909090909091,2019-03-06
82,20,10,1,0,113,5.345132743362832,2019-03-05
84,16,13,0,0,113,5.513274336283186,2019-03-04
86,14,11,0,0,111,5.387387387387387,2019-03-03
81,18,10,0,0,109,5.422018348623853,2019-03-02
85,17,9,0,1,112,5.321428571428571,2019-03-01
85,25,7,1,1,119,5.6722689075630255,2019-02-28
87,25,5,0,1,118,5.262711864406779,2019-02-27
83,28,4,0,1,116,5.112068965517241,2019-02-26
70,26,2,0,1,99,5.090909090909091,2019-02-25
70,24,1,1,1,97,5.206185567010309,2019-02-24
70,22,2,1,1,96,4.885416666666667,2019-02-23
72,23,3,2,0,100,5.1,2019-02-22
80,21,4,2,0,107,5.233644859813084,2019-02-21
84,26,4,2,0,116,5.413793103448276,2019-02-20
89,19,8,2,1,119,5.638655462184874,2019-02-19
97,18,9,2,1,127,5.692913385826771,2019-02-18
93,18,8,2,1,122,5.327868852459017,2019-02-17
99,21,8,3,3,134,5.7164179104477615,2019-02-16
97,15,10,3,3,128,5.8515625,2019-02-15
89,17,13,4,3,126,6.507936507936508,2019-02-14
82,30,11,4,4,131,7.0,2019-02-13
82,42,11,4,4,143,7.195804195804196,2019-02-12
71,46,11,5,3,136,7.522058823529412,2019-02-11
78,37,10,5,3,133,7.022556390977444,2019-02-10
84,36,8,5,2,135,6.866666666666666,2019-02-09
76,46,16,8,3,149,8.335570469798657,2019-02-08
87,47,19,7,3,163,8.006134969325153,2019-02-07
91,45,22,7,2,167,7.634730538922156,2019-02-06
97,37,21,7,2,164,7.469512195121951,2019-02-05
101,38,23,6,1,169,7.1420118343195265,2019-02-04
109,42,21,6,0,178,6.904494382022472,2019-02-03
111,31,21,4,0,167,6.580838323353293,2019-02-02
107,33,25,4,0,169,6.810650887573964,2019-02-01
109,36,22,5,0,172,6.604651162790698,2019-01-31
112,43,20,4,0,179,6.329608938547486,2019-01-30
115,50,20,8,0,193,6.979274611398964,2019-01-29
114,52,16,9,0,191,6.769633507853404,2019-01-28
105,47,16,6,0,174,6.902298850574713,2019-01-27
95,64,18,4,0,181,7.099447513812155,2019-01-26
102,62,26,3,0,193,6.979274611398964,2019-01-25
102,69,34,2,0,207,7.3768115942028984,2019-01-24
119,69,30,1,0,219,6.899543378995434,2019-01-23
115,63,27,0,0,205,6.746341463414634,2019-01-22
120,57,22,0,0,199,6.386934673366834,2019-01-21
124,56,14,0,0,194,6.06701030927835,2019-01-20
133,52,13,0,0,198,5.545454545454546,2019-01-19
139,49,10,0,0,198,5.111111111111111,2019-01-18
131,51,6,1,0,189,5.1005291005291005,2019-01-17
118,45,6,1,0,170,5.064705882352941,2019-01-16
115,38,2,1,0,156,4.608974358974359,2019-01-15
111,44,2,3,0,160,4.93125,2019-01-14
115,27,3,1,0,146,4.671232876712328,2019-01-13
116,27,4,1,0,148,4.547297297297297,2019-01-12
110,24,6,0,0,140,4.635714285714286,2019-01-11
107,21,5,0,0,133,4.6992481203007515,2019-01-10
106,24,7,1,0,138,4.688405797101449,2019-01-09
115,20,6,1,0,142,4.338028169014085,2019-01-08
112,17,6,0,0,135,4.177777777777778,2019-01-07
96,23,6,0,0,125,4.632,2019-01-06
96,30,6,2,0,134,5.104477611940299,2019-01-05
108,19,5,2,0,134,4.880597014925373,2019-01-04
107,20,11,4,2,144,5.979166666666667,2019-01-03
105,19,10,5,1,140,5.792857142857143,2019-01-02
90,19,9,5,2,125,5.984,2019-01-01
84,17,13,3,2,119,6.07563025210084,2018-12-31
93,16,14,5,1,129,5.9689922480620154,2018-12-30
92,29,22,8,2,153,7.352941176470588,2018-12-29
76,42,17,7,2,144,7.902777777777778,2018-12-28
85,55,23,9,3,175,8.577142857142857,2018-12-27
98,57,32,12,4,203,9.364532019704434,2018-12-26
108,51,29,11,4,203,8.74384236453202,2018-12-25
110,56,25,10,6,207,8.483091787439614,2018-12-24
103,49,26,7,6,191,8.44502617801047,2018-12-23
108,39,27,7,5,186,8.25268817204301,2018-12-22
112,42,24,6,5,189,7.767195767195767,2018-12-21
105,42,22,5,5,179,7.865921787709497,2018-12-20
92,44,24,10,4,174,8.89655172413793,2018-12-19
86,43,20,9,5,163,8.98159509202454,2018-12-18
92,38,21,10,5,166,8.433734939759036,2018-12-17
92,40,23,8,6,169,8.65680473372781,2018-12-16
82,55,28,6,6,177,8.728813559322035,2018-12-15
90,42,29,10,6,177,8.807909604519773,2018-12-14
92,39,25,9,5,170,8.611764705882353,2018-12-13
101,45,22,7,3,178,8.044943820224718,2018-12-12
103,51,28,6,3,191,7.9214659685863875,2018-12-11
101,51,29,4,5,190,9.178947368421053,2018-12-10
108,45,21,5,7,186,9.053763440860216,2018-12-09
109,44,17,7,6,183,8.852459016393443,2018-12-08
97,47,18,7,6,175,9.034285714285714,2018-12-07
95,42,15,7,5,164,9.121951219512194,2018-12-06
99,38,14,8,2,161,9.0,2018-12-05
96,37,14,7,2,156,8.916666666666666,2018-12-04
97,43,18,9,1,168,7.380952380952381,2018-12-03
99,39,19,8,2,167,7.431137724550898,2018-12-02
98,38,19,8,3,166,7.759036144578313,2018-12-01
98,41,17,8,3,167,7.3053892215568865,2018-11-30
92,36,17,10,3,158,7.6835443037974684,2018-11-29
89,30,16,6,4,145,7.924137931034482,2018-11-28
87,34,19,5,4,149,7.818791946308725,2018-11-27
88,30,20,3,6,147,7.700680272108843,2018-11-26
80,29,18,4,5,136,7.882352941176471,2018-11-25
77,28,19,4,5,133,8.052631578947368,2018-11-24
80,27,20,4,5,136,7.669117647058823,2018-11-23
81,27,15,4,5,132,7.598484848484849,2018-11-22
81,33,13,2,6,135,7.977777777777778,2018-11-21
82,37,14,2,6,141,7.808510638297872,2018-11-20
84,31,12,3,6,136,7.4411764705882355,2018-11-19
90,42,14,4,7,157,7.694267515923567,2018-11-18
90,43,13,6,5,157,7.471337579617835,2018-11-17
99,42,14,7,3,165,7.072727272727272,2018-11-16
97,53,14,6,2,172,7.244186046511628,2018-11-15
96,55,16,8,1,176,7.505681818181818,2018-11-14
104,55,17,7,2,185,7.151351351351352,2018-11-13
121,41,17,8,2,189,6.8201058201058204,2018-11-12
114,35,15,9,0,173,6.53757225433526,2018-11-11
114,30,12,8,0,164,6.0182926829268295,2018-11-10
108,32,12,6,1,159,6.012578616352202,2018-11-09
112,29,11,4,1,157,5.89171974522293,2018-11-08
111,26,14,3,2,156,5.92948717948718,2018-11-07
105,32,14,5,2,158,6.215189873417722,2018-11-06
95,35,19,4,2,155,6.941935483870968,2018-11-05
94,41,23,2,2,162,6.987654320987654,2018-11-04
93,36,20,3,1,153,6.849673202614379,2018-11-03
98,29,16,3,1,147,6.217687074829932,2018-11-02
91,26,19,3,2,141,7.00709219858156,2018-11-01
88,34,16,3,2,143,6.706293706293707,2018-10-31
91,25,15,3,2,136,6.360294117647059,2018-10-30
90,28,15,3,3,139,6.848920863309353,2018-10-29
83,41,9,4,3,140,6.7,2018-10-28
84,38,12,2,3,139,6.762589928057554,2018-10-27
77,37,12,3,3,132,6.878787878787879,2018-10-26
72,40,12,7,1,132,7.3106060606060606,2018-10-25
80,37,12,7,1,137,7.036496350364963,2018-10-24
78,40,17,8,1,144,7.729166666666667,2018-10-23
79,42,14,12,2,149,8.21476510067114,2018-10-22
88,35,15,7,2,147,7.428571428571429,2018-10-21
85,35,21,5,1,147,7.72108843537415,2018-10-20
89,42,23,4,2,160,7.44375,2018-10-19
97,39,24,2,3,165,7.448484848484848,2018-10-18
92,37,27,8,5,169,8.532544378698224,2018-10-17
87,37,28,7,4,163,8.294478527607362,2018-10-16
81,35,29,5,4,154,8.35064935064935,2018-10-15
81,36,27,4,4,152,8.19078947368421,2018-10-14
67,49,36,6,6,164,9.731707317073171,2018-10-13
68,63,30,3,7,171,9.461988304093568,2018-10-12
64,64,33,5,6,172,9.912790697674419,2018-10-11
69,68,35,4,7,183,9.846994535519126,2018-10-10
72,68,32,4,8,184,9.592391304347826,2018-10-09
76,68,27,1,9,181,9.121546961325967,2018-10-08
77,70,19,2,8,176,8.744318181818182,2018-10-07
84,64,19,4,7,178,8.359550561797754,2018-10-06
90,58,17,6,5,176,8.193181818181818,2018-10-05
88,54,20,11,4,177,8.68361581920904,2018-10-04
81,56,23,22,3,185,9.6,2018-10-03
76,51,23,21,3,174,9.574712643678161,2018-10-02
80,53,22,26,1,182,9.67032967032967,2018-10-01
83,50,35,27,4,199,10.467336683417086,2018-09-30
72,51,39,18,4,184,10.630434782608695,2018-09-29
65,59,47,14,4,189,10.904761904761905,2018-09-28
70,59,47,13,3,192,10.473958333333334,2018-09-27
70,56,60,11,3,200,10.565,2018-09-26
65,65,56,11,1,198,10.186868686868687,2018-09-25
65,58,55,8,1,187,10.406417112299465,2018-09-24
67,61,53,8,2,191,9.99476439790576,2018-09-23
73,77,33,7,1,191,9.366492146596858,2018-09-22
77,76,24,7,2,186,8.935483870967742,2018-09-21
81,71,20,5,2,179,8.491620111731844,2018-09-20
77,82,20,7,4,190,8.457894736842105,2018-09-19
78,79,23,11,2,193,8.813471502590673,2018-09-18
82,86,15,9,2,194,8.29896907216495,2018-09-17
88,82,15,11,2,198,8.217171717171718,2018-09-16
101,76,21,11,2,211,8.336492890995261,2018-09-15
106,58,26,7,2,199,8.21608040201005,2018-09-14
114,68,26,5,2,215,7.632558139534884,2018-09-13
111,58,26,3,2,200,7.215,2018-09-12
117,58,32,1,2,210,7.095238095238095,2018-09-11
121,50,31,1,1,204,6.970588235294118,2018-09-10
98,50,25,4,2,179,7.731843575418995,2018-09-09
90,54,23,4,1,172,7.546511627906977,2018-09-08
92,55,21,3,1,172,7.133720930232558,2018-09-07
97,50,26,5,1,179,7.424581005586592,2018-09-06
91,66,22,7,1,187,7.818181818181818,2018-09-05
80,71,14,9,1,175,8.222857142857142,2018-09-04
87,62,15,8,1,173,8.028901734104046,2018-09-03
89,63,18,5,1,176,7.6477272727272725,2018-09-02
92,52,19,6,0,169,7.372781065088757,2018-09-01
86,44,18,7,0,155,7.393548387096774,2018-08-31
85,44,17,5,0,151,6.900662251655629,2018-08-30
95,34,20,3,0,152,6.519736842105263,2018-08-29
95,42,31,7,0,175,7.954285714285715,2018-08-28
94,43,26,6,0,169,7.603550295857988,2018-08-27
95,37,21,5,0,158,7.322784810126582,2018-08-26
92,68,23,6,0,189,7.915343915343915,2018-08-25
91,71,19,7,0,188,7.4787234042553195,2018-08-24
89,67,21,2,0,179,7.268156424581005,2018-08-23
86,63,17,1,0,167,7.173652694610778,2018-08-22
87,58,20,0,0,165,7.218181818181818,2018-08-21
87,58,19,0,0,164,7.109756097560975,2018-08-20
94,54,18,3,0,169,7.041420118343195,2018-08-19
100,53,17,2,0,172,6.5813953488372094,2018-08-18
98,54,17,1,0,170,6.482352941176471,2018-08-17
98,56,13,0,0,167,6.161676646706587,2018-08-16
103,50,9,9,0,171,7.0701754385964914,2018-08-15
104,53,6,10,0,173,6.959537572254336,2018-08-14
103,43,13,7,0,166,6.993975903614458,2018-08-13
104,47,16,8,0,175,6.925714285714286,2018-08-12
105,42,20,6,1,174,7.028735632183908,2018-08-11
99,47,22,6,1,175,7.097142857142857,2018-08-10
101,37,25,7,3,173,7.971098265895954,2018-08-09
105,34,25,5,4,173,8.052023121387283,2018-08-08
102,83,24,6,5,220,8.845454545454546,2018-08-07
104,83,20,7,5,219,8.337899543378995,2018-08-06
106,84,18,7,5,220,7.890909090909091,2018-08-05
112,90,17,7,6,232,7.5905172413793105,2018-08-04
137,62,21,8,7,235,8.238297872340425,2018-08-03
123,60,25,8,5,221,8.167420814479637,2018-08-02
121,63,24,8,9,225,8.377777777777778,2018-08-01
126,64,22,6,8,226,8.008849557522124,2018-07-31
139,48,22,5,9,223,7.663677130044843,2018-07-30
130,64,20,7,8,229,7.441048034934497,2018-07-29
97,53,15,9,6,180,8.25,2018-07-28
110,44,18,7,7,186,7.913978494623656,2018-07-27
113,56,19,7,7,202,7.96039603960396,2018-07-26
107,62,20,9,7,205,7.975609756097561,2018-07-25
108,64,26,12,5,215,8.586046511627908,2018-07-24
118,70,29,10,4,231,8.441558441558442,2018-07-23
117,64,32,11,4,228,8.359649122807017,2018-07-22
113,58,33,9,4,217,8.244239631336406,2018-07-21
123,48,28,10,2,211,7.691943127962086,2018-07-20
130,57,32,14,2,235,8.029787234042553,2018-07-19
111,56,27,15,1,210,8.366666666666667,2018-07-18
100,62,30,12,1,205,8.482926829268292,2018-07-17
93,66,23,10,1,193,8.243523316062177,2018-07-16
96,70,22,10,1,199,8.236180904522612,2018-07-15
82,61,20,13,1,177,8.581920903954803,2018-07-14
82,47,25,11,1,166,8.728915662650602,2018-07-13
85,75,31,10,1,202,8.811881188118813,2018-07-12
94,77,33,6,1,211,8.492890995260664,2018-07-11
97,68,32,3,1,201,8.189054726368159,2018-07-10
99,68,35,1,1,204,8.200980392156863,2018-07-09
104,66,34,1,1,206,7.878640776699029,2018-07-08
99,61,38,4,1,203,8.16256157635468,2018-07-07
98,67,34,1,0,200,7.525,2018-07-06
98,60,31,0,0,189,7.126984126984127,2018-07-05
97,67,24,0,0,188,7.26063829787234,2018-07-04
95,71,20,0,0,186,7.32258064516129,2018-07-03
96,82,15,0,0,193,7.233160621761658,2018-07-02
96,78,13,0,0,187,6.764705882352941,2018-07-01
95,69,13,0,1,178,6.5,2018-06-30
96,61,10,0,1,168,6.238095238095238,2018-06-29
89,61,6,0,1,157,6.031847133757962,2018-06-28
103,44,10,1,1,159,6.452830188679245,2018-06-27
105,39,11,1,1,157,6.32484076433121,2018-06-26
114,45,13,0,1,173,6.219653179190751,2018-06-25
117,33,12,0,1,163,5.693251533742331,2018-06-24
108,33,10,0,1,152,5.427631578947368,2018-06-23
104,29,16,0,1,150,5.446666666666666,2018-06-22
88,31,12,1,1,133,6.12781954887218,2018-06-21
77,32,12,2,1,124,6.629032258064516,2018-06-20
69,41,16,2,1,129,7.170542635658915,2018-06-19
71,48,12,2,1,134,7.231343283582089,2018-06-18
79,43,6,2,1,131,6.595419847328245,2018-06-17
81,38,8,0,1,128,6.296875,2018-06-16
78,39,12,0,1,130,6.523076923076923,2018-06-15
85,44,11,0,3,143,6.8321678321678325,2018-06-14
86,52,11,4,0,153,6.758169934640523,2018-06-13
87,48,10,3,0,148,6.466216216216216,2018-06-12
89,54,11,3,0,157,6.624203821656051,2018-06-11
102,36,10,3,0,151,6.271523178807947,2018-06-10
103,38,9,3,0,153,6.03921568627451,2018-06-09
100,31,9,3,0,143,5.706293706293707,2018-06-08
105,37,10,3,0,155,5.896774193548387,2018-06-07
101,31,13,0,0,145,5.76551724137931,2018-06-06
94,34,11,0,0,139,5.690647482014389,2018-06-05
82,52,11,0,0,145,6.406896551724138,2018-06-04
84,39,9,0,0,132,6.151515151515151,2018-06-03
81,43,7,0,0,131,5.854961832061068,2018-06-02
73,62,8,0,0,143,6.34965034965035,2018-06-01
78,63,10,0,0,151,6.3841059602649,2018-05-31
88,64,5,0,0,157,5.949044585987261,2018-05-30
111,51,9,0,0,171,6.081871345029239,2018-05-29
110,56,9,0,1,176,6.875,2018-05-28
129,46,7,0,1,183,6.3497267759562845,2018-05-27
134,42,5,0,1,182,5.824175824175824,2018-05-26
126,59,4,0,1,190,5.8578947368421055,2018-05-25
123,54,4,0,1,182,5.571428571428571,2018-05-24
115,36,6,0,1,158,5.905063291139241,2018-05-23
111,33,7,0,1,152,5.756578947368421,2018-05-22
96,37,6,0,0,139,5.251798561151079,2018-05-21
106,39,5,0,0,150,5.406666666666666,2018-05-20
109,26,5,0,0,140,4.814285714285714,2018-05-19
114,21,5,0,0,140,4.542857142857143,2018-05-18
97,23,4,0,0,124,5.016129032258065,2018-05-17
94,25,4,0,0,123,4.585365853658536,2018-05-16
86,21,5,0,0,112,4.428571428571429,2018-05-15
74,14,3,0,0,91,4.4945054945054945,2018-05-14
71,12,2,0,0,85,4.4,2018-05-13
60,12,1,0,0,73,4.561643835616438,2018-05-12
63,20,1,0,0,84,4.761904761904762,2018-05-11
73,9,3,0,0,85,4.517647058823529,2018-05-10
75,18,1,0,0,94,4.702127659574468,2018-05-09
79,30,1,0,0,110,5.1454545454545455,2018-05-08
86,19,1,0,0,106,4.962264150943396,2018-05-07
89,20,4,0,0,113,4.902654867256637,2018-05-06
91,14,4,0,0,109,4.458715596330276,2018-05-05
83,16,3,1,0,103,4.601941747572815,2018-05-04
79,13,2,1,0,95,4.136842105263158,2018-05-03
72,8,2,0,0,82,4.121951219512195,2018-05-02
58,20,6,0,0,84,5.583333333333333,2018-05-01
68,21,4,0,0,93,5.387096774193548,2018-04-30
61,23,4,0,0,88,5.545454545454546,2018-04-29
62,31,5,0,0,98,5.63265306122449,2018-04-28
64,25,7,0,0,96,5.416666666666667,2018-04-27
67,26,10,0,0,103,5.980582524271845,2018-04-26
68,27,7,1,0,103,5.980582524271845,2018-04-25
69,23,10,2,0,104,6.538461538461538,2018-04-24
70,23,6,2,0,101,6.188118811881188,2018-04-23
70,33,10,1,0,114,6.245614035087719,2018-04-22
70,31,7,0,0,108,5.87037037037037,2018-04-21
70,39,6,0,0,115,5.930434782608696,2018-04-20
75,46,4,0,0,125,5.696,2018-04-19
91,27,5,0,0,123,5.666666666666667,2018-04-18
88,33,5,0,0,126,5.611111111111111,2018-04-17
99,37,4,1,0,141,5.361702127659575,2018-04-16
107,46,3,1,0,157,5.3630573248407645,2018-04-15
119,44,2,0,0,165,4.824242424242424,2018-04-14
121,26,2,0,0,149,4.442953020134228,2018-04-13
102,21,0,0,0,123,4.504065040650406,2018-04-12
101,20,1,1,0,123,4.195121951219512,2018-04-11
96,15,0,1,0,112,4.0,2018-04-10
88,14,2,0,0,104,4.028846153846154,2018-04-09
76,24,4,0,0,104,4.788461538461538,2018-04-08
69,18,4,0,0,91,4.835164835164835,2018-04-07
67,18,4,0,0,89,5.067415730337078,2018-04-06
73,18,2,0,0,93,5.043010752688172,2018-04-05
66,20,2,1,1,90,5.722222222222222,2018-04-04
62,20,4,1,1,88,6.386363636363637,2018-04-03
67,32,6,1,1,107,6.308411214953271,2018-04-02
71,29,3,1,1,105,6.076190476190476,2018-04-01
61,34,6,1,1,103,6.29126213592233,2018-03-31
62,31,3,1,1,98,6.163265306122449,2018-03-30
68,26,2,1,1,98,5.73469387755102,2018-03-29
69,28,2,0,1,100,5.72,2018-03-28
73,37,3,0,1,114,5.780701754385965,2018-03-27
68,33,3,0,1,105,5.695238095238095,2018-03-26
80,24,1,0,1,106,5.132075471698113,2018-03-25
81,26,1,0,1,109,5.073394495412844,2018-03-24
76,20,2,0,1,99,4.98989898989899,2018-03-23
76,16,2,0,1,95,4.747368421052632,2018-03-22
77,19,2,0,1,99,4.818181818181818,2018-03-21
84,20,5,0,1,110,5.1,2018-03-20
79,22,2,1,0,104,5.1826923076923075,2018-03-19
78,16,4,2,0,100,5.4,2018-03-18
73,14,3,2,0,92,5.228260869565218,2018-03-17
71,20,7,2,0,100,5.77,2018-03-16
68,19,8,3,0,98,5.795918367346939,2018-03-15
61,33,6,2,0,102,6.235294117647059,2018-03-14
58,37,5,0,0,100,6.14,2018-03-13
61,32,6,0,0,99,6.181818181818182,2018-03-12
69,28,7,1,0,105,6.171428571428572,2018-03-11
75,20,8,0,0,103,5.805825242718447,2018-03-10
75,42,10,0,0,127,6.078740157480315,2018-03-09
94,21,10,0,0,125,5.456,2018-03-08
102,20,8,1,0,131,5.343511450381679,2018-03-07
99,32,3,1,0,135,5.185185185185185,2018-03-06
93,26,6,0,0,125,5.28,2018-03-05
90,30,6,0,0,126,5.238095238095238,2018-03-04
90,36,5,0,0,131,5.0458015267175576,2018-03-03
80,40,5,1,0,126,5.642857142857143,2018-03-02
81,37,4,1,0,123,5.560975609756097,2018-03-01
89,28,6,0,0,123,5.365853658536586,2018-02-28
96,26,7,0,0,129,5.224806201550388,2018-02-27
104,22,3,0,0,129,4.8604651162790695,2018-02-26
100,19,5,0,0,124,4.766129032258065,2018-02-25
93,23,4,0,0,120,4.666666666666667,2018-02-24
87,20,3,0,0,110,4.4363636363636365,2018-02-23
75,24,2,1,0,102,4.764705882352941,2018-02-22
69,26,0,1,0,96,4.875,2018-02-21
60,21,0,1,0,82,5.036585365853658,2018-02-20
70,18,2,0,0,90,5.155555555555556,2018-02-19
71,19,2,0,0,92,4.989130434782608,2018-02-18
73,12,2,0,0,87,4.540229885057471,2018-02-17
71,18,4,0,0,93,4.645161290322581,2018-02-16
70,27,4,0,0,101,4.871287128712871,2018-02-15
80,22,2,0,0,104,4.846153846153846,2018-02-14
77,24,3,0,0,104,5.144230769230769,2018-02-13
80,27,3,0,0,110,5.372727272727273,2018-02-12
81,25,3,0,0,109,5.26605504587156,2018-02-11
88,28,1,0,0,117,4.666666666666667,2018-02-10
91,23,3,0,0,117,4.47008547008547,2018-02-09
85,23,5,0,0,113,5.053097345132743,2018-02-08
77,32,4,0,0,113,5.256637168141593,2018-02-07
79,26,3,0,0,108,5.222222222222222,2018-02-06
78,31,6,1,1,117,6.213675213675214,2018-02-05
77,36,5,1,1,120,6.0,2018-02-04
83,25,6,1,1,116,5.879310344827586,2018-02-03
77,32,9,1,1,120,6.091666666666667,2018-02-02
81,37,17,0,1,136,6.720588235294118,2018-02-01
82,39,23,0,1,145,7.158620689655172,2018-01-31
79,52,22,0,1,154,7.305194805194805,2018-01-30
88,46,23,1,1,159,7.138364779874214,2018-01-29
77,50,21,2,0,150,7.253333333333333,2018-01-28
88,40,14,2,0,144,6.805555555555555,2018-01-27
81,48,11,2,0,142,6.802816901408451,2018-01-26
81,58,6,2,0,147,6.469387755102041,2018-01-25
84,51,6,1,0,142,6.211267605633803,2018-01-24
85,41,7,2,0,135,6.385185185185185,2018-01-23
86,41,8,3,0,138,6.057971014492754,2018-01-22
77,41,11,1,0,130,6.2,2018-01-21
94,40,11,0,0,145,6.0137931034482754,2018-01-20
95,39,13,2,0,149,6.2885906040268456,2018-01-19
94,38,12,2,0,146,6.089041095890411,2018-01-18
88,37,12,4,0,141,6.709219858156028,2018-01-17
93,39,7,2,0,141,6.205673758865248,2018-01-16
88,58,10,3,0,159,6.3081761006289305,2018-01-15
80,57,9,4,0,150,6.593333333333334,2018-01-14
86,55,8,5,0,154,6.6558441558441555,2018-01-13
100,41,11,1,0,153,6.150326797385621,2018-01-12
100,38,10,3,0,151,6.258278145695364,2018-01-11
106,31,11,2,0,150,5.986666666666666,2018-01-10
120,23,12,2,0,157,5.802547770700637,2018-01-09
110,39,16,2,0,167,5.8562874251497,2018-01-08
106,34,15,2,0,157,5.681528662420382,2018-01-07
98,25,16,2,0,141,5.98581560283688,2018-01-06
89,25,13,3,0,130,6.246153846153846,2018-01-05
81,27,17,3,0,128,6.8046875,2018-01-04
66,41,21,4,0,132,7.7272727272727275,2018-01-03
79,38,19,2,0,138,7.340579710144928,2018-01-02
69,37,20,2,0,128,7.3203125,2018-01-01
60,38,25,2,0,125,8.248,2017-12-31
56,46,24,2,0,128,8.140625,2017-12-30
65,44,21,3,0,133,8.090225563909774,2017-12-29
66,50,18,2,0,136,7.522058823529412,2017-12-28
59,52,15,1,0,127,7.692913385826771,2017-12-27
66,53,13,0,0,132,7.303030303030303,2017-12-26
66,50,11,0,0,127,7.15748031496063,2017-12-25
64,56,13,0,0,133,7.105263157894737,2017-12-24
66,55,15,0,0,136,7.073529411764706,2017-12-23
73,50,21,1,0,145,7.268965517241379,2017-12-22
76,52,16,2,0,146,7.102739726027397,2017-12-21
74,50,11,2,0,137,7.0,2017-12-20
77,45,10,7,0,139,7.424460431654676,2017-12-19
84,41,12,5,0,142,7.056338028169014,2017-12-18
74,45,19,4,0,142,7.394366197183099,2017-12-17
72,55,15,6,0,148,7.45945945945946,2017-12-16
73,48,15,3,0,139,6.985611510791367,2017-12-15
76,48,16,1,0,141,7.0212765957446805,2017-12-14
76,40,17,1,0,134,6.917910447761194,2017-12-13
82,33,18,1,0,134,6.731343283582089,2017-12-12
88,40,10,1,0,139,6.287769784172662,2017-12-11
92,34,8,1,0,135,5.718518518518518,2017-12-10
94,30,11,1,0,136,5.727941176470588,2017-12-09
82,38,10,2,0,132,6.128787878787879,2017-12-08
81,43,8,1,0,133,6.082706766917293,2017-12-07
77,44,7,1,0,129,6.1937984496124034,2017-12-06
68,49,12,3,0,132,6.7272727272727275,2017-12-05
78,30,13,3,0,124,6.661290322580645,2017-12-04
74,31,11,2,0,118,6.52542372881356,2017-12-03
80,36,10,2,0,128,6.2421875,2017-12-02
75,44,9,5,0,133,6.834586466165414,2017-12-01
76,52,11,3,2,144,7.256944444444445,2017-11-30
90,45,12,1,2,150,6.786666666666667,2017-11-29
76,47,18,2,2,145,7.689655172413793,2017-11-28
81,41,19,5,1,147,7.551020408163265,2017-11-27
84,33,19,6,0,142,7.154929577464789,2017-11-26
86,40,23,6,1,156,7.589743589743589,2017-11-25
84,32,27,5,1,149,7.416107382550336,2017-11-24
80,32,20,7,0,139,7.697841726618705,2017-11-23
84,47,14,6,1,152,7.756578947368421,2017-11-22
75,60,10,5,1,151,7.569536423841059,2017-11-21
73,73,13,4,1,164,7.146341463414634,2017-11-20
88,56,13,4,0,161,6.962732919254658,2017-11-19
100,49,9,5,0,163,6.723926380368098,2017-11-18
90,53,10,4,0,157,6.6687898089171975,2017-11-17
101,40,11,2,0,154,6.220779220779221,2017-11-16
113,28,9,2,0,152,5.644736842105263,2017-11-15
121,22,8,2,0,153,4.823529411764706,2017-11-14
93,25,7,2,0,127,5.2362204724409445,2017-11-13
76,48,9,1,1,135,6.303703703703704,2017-11-12
80,37,10,0,1,128,5.7578125,2017-11-11
67,33,8,0,1,109,5.834862385321101,2017-11-10
59,41,11,0,1,112,7.232142857142857,2017-11-09
61,33,11,0,1,106,6.943396226415095,2017-11-08
70,29,6,0,1,106,6.264150943396227,2017-11-07
73,36,7,1,1,118,6.093220338983051,2017-11-06
70,35,5,2,0,112,6.026785714285714,2017-11-05
70,34,4,2,0,110,5.836363636363636,2017-11-04
63,28,4,1,0,96,5.708333333333333,2017-11-03
64,22,3,1,0,90,5.366666666666666,2017-11-02
59,25,3,3,0,90,5.955555555555556,2017-11-01
64,16,6,4,0,90,6.188888888888889,2017-10-31
62,21,9,4,0,96,6.354166666666667,2017-10-30
63,20,8,3,0,94,6.276595744680851,2017-10-29
58,20,9,2,0,89,6.325842696629214,2017-10-28
58,21,9,1,0,89,6.303370786516854,2017-10-27
57,18,9,1,0,85,6.152941176470589,2017-10-26
48,26,7,1,0,82,6.536585365853658,2017-10-25
48,26,10,1,2,87,7.609195402298851,2017-10-24
44,36,14,4,3,101,8.712871287128714,2017-10-23
51,24,14,4,4,97,8.649484536082474,2017-10-22
49,24,10,3,4,90,8.4,2017-10-21
49,29,11,4,5,98,9.326530612244898,2017-10-20
57,29,14,5,7,112,9.5,2017-10-19
62,33,19,5,6,125,9.288,2017-10-18
63,33,20,6,8,130,9.715384615384615,2017-10-17
58,34,19,5,7,123,9.75609756097561,2017-10-16
63,35,18,7,5,128,9.296875,2017-10-15
62,35,14,7,5,123,8.845528455284553,2017-10-14
61,38,13,5,6,123,8.894308943089431,2017-10-13
56,38,11,6,5,116,8.827586206896552,2017-10-12
52,38,11,5,5,111,8.855855855855856,2017-10-11
55,36,12,7,7,117,9.188034188034187,2017-10-10
53,52,10,10,6,131,9.526717557251908,2017-10-09
60,43,12,11,3,129,9.023255813953488,2017-10-08
66,37,11,9,2,125,8.552,2017-10-07
71,42,10,9,2,134,8.164179104477611,2017-10-06
79,47,14,8,2,150,7.8133333333333335,2017-10-05
87,43,15,8,3,156,7.833333333333333,2017-10-04
88,40,16,9,2,155,7.490322580645161,2017-10-03
90,34,16,8,2,150,7.293333333333333,2017-10-02
85,37,17,8,1,148,7.533783783783784,2017-10-01
86,32,18,6,0,142,7.47887323943662,2017-09-30
86,35,21,10,0,152,7.875,2017-09-29
75,36,22,11,1,145,8.6,2017-09-28
71,42,23,10,2,148,8.783783783783784,2017-09-27
64,60,26,7,1,158,8.765822784810126,2017-09-26
65,62,24,7,3,161,8.763975155279503,2017-09-25
68,57,21,6,4,156,8.782051282051283,2017-09-24
80,47,18,6,2,153,8.281045751633988,2017-09-23
80,54,25,8,3,170,8.723529411764705,2017-09-22
86,60,25,8,4,183,8.863387978142077,2017-09-21
90,59,24,10,7,190,9.147368421052631,2017-09-20
87,59,20,12,6,184,9.168478260869565,2017-09-19
82,63,23,13,6,187,9.491978609625669,2017-09-18
76,64,18,16,7,181,9.762430939226519,2017-09-17
75,59,17,16,6,173,9.763005780346822,2017-09-16
68,62,20,14,6,170,9.735294117647058,2017-09-15
75,52,19,14,6,166,9.74698795180723,2017-09-14
76,41,20,16,7,160,10.1125,2017-09-13
81,37,22,14,7,161,9.813664596273291,2017-09-12
75,36,22,13,8,154,10.012987012987013,2017-09-11
72,35,24,12,7,150,9.986666666666666,2017-09-10
76,35,24,9,8,152,9.585526315789474,2017-09-09
62,42,23,8,10,145,10.027586206896551,2017-09-08
64,51,26,13,11,165,10.975757575757576,2017-09-07
64,42,25,12,11,154,10.766233766233766,2017-09-06
64,44,21,12,12,153,10.562091503267974,2017-09-05
67,35,23,15,6,146,10.280821917808218,2017-09-04
60,32,23,15,3,133,10.240601503759398,2017-09-03
65,42,16,14,3,140,9.35,2017-09-02
57,36,14,16,1,124,9.588709677419354,2017-09-01
54,38,16,12,4,124,10.161290322580646,2017-08-31
54,36,17,12,5,124,9.943548387096774,2017-08-30
59,29,20,12,5,125,9.864,2017-08-29
62,35,24,6,5,132,9.378787878787879,2017-08-28
63,35,20,3,6,127,9.062992125984252,2017-08-27
64,24,18,3,6,115,8.904347826086957,2017-08-26
59,24,20,2,4,109,8.385321100917432,2017-08-25
64,24,19,6,2,115,8.634782608695652,2017-08-24
67,47,31,9,7,161,10.198757763975156,2017-08-23
64,49,28,9,6,156,9.775641025641026,2017-08-22
68,56,19,17,12,172,10.680232558139535,2017-08-21
68,47,15,20,9,159,10.660377358490566,2017-08-20
72,51,17,19,8,167,10.41317365269461,2017-08-19
61,56,24,14,7,162,10.469135802469136,2017-08-18
61,54,24,12,4,155,10.283870967741935,2017-08-17
62,59,23,11,4,159,9.584905660377359,2017-08-16
66,53,26,10,5,160,9.61875,2017-08-15
68,38,24,11,4,145,9.586206896551724,2017-08-14
67,30,24,9,4,134,9.574626865671641,2017-08-13
71,34,22,7,4,138,8.753623188405797,2017-08-12
70,42,16,6,3,137,8.437956204379562,2017-08-11
77,40,12,5,4,138,7.9855072463768115,2017-08-10
77,44,20,8,5,154,9.136363636363637,2017-08-09
68,54,19,8,4,153,9.320261437908497,2017-08-08
62,59,24,9,3,157,9.394904458598726,2017-08-07
65,58,19,11,3,156,8.878205128205128,2017-08-06
66,48,16,10,3,143,8.657342657342657,2017-08-05
74,37,16,9,5,141,8.98581560283688,2017-08-04
65,42,18,8,7,140,10.778571428571428,2017-08-03
68,43,17,4,7,139,10.323741007194245,2017-08-02
72,37,18,3,7,137,9.91970802919708,2017-08-01
70,46,18,3,6,143,9.573426573426573,2017-07-31
69,44,17,3,5,138,9.398550724637682,2017-07-30
56,40,15,3,5,119,9.739495798319327,2017-07-29
57,40,15,3,5,120,9.475,2017-07-28
58,35,12,3,6,114,9.771929824561404,2017-07-27
59,35,8,3,6,111,9.63963963963964,2017-07-26
64,32,8,5,6,115,9.4,2017-07-25
60,30,10,4,5,109,9.596330275229358,2017-07-24
65,28,11,4,4,112,8.973214285714286,2017-07-23
59,30,7,5,3,104,8.846153846153847,2017-07-22
55,34,8,4,2,103,8.563106796116505,2017-07-21
54,26,8,3,2,93,8.709677419354838,2017-07-20
53,22,8,3,1,87,7.241379310344827,2017-07-19
50,25,10,4,1,90,7.455555555555556,2017-07-18
54,29,15,5,3,106,8.641509433962264,2017-07-17
52,46,14,3,3,118,8.525423728813559,2017-07-16
60,37,18,5,2,122,8.655737704918034,2017-07-15
58,42,17,6,1,124,8.733870967741936,2017-07-14
57,40,15,5,1,118,8.288135593220339,2017-07-13
64,46,18,3,1,132,7.886363636363637,2017-07-12
55,53,15,4,0,127,7.669291338582677,2017-07-11
65,44,10,4,0,123,7.065040650406504,2017-07-10
63,36,6,4,0,109,6.844036697247707,2017-07-09
66,34,8,2,0,110,6.527272727272727,2017-07-08
70,26,9,1,1,107,6.616822429906542,2017-07-07
67,31,10,3,2,113,7.292035398230088,2017-07-06
73,34,11,2,2,122,6.909836065573771,2017-07-05
65,29,12,1,2,109,6.954128440366972,2017-07-04
62,28,14,1,2,107,7.037383177570093,2017-07-03
64,22,12,1,2,101,6.96039603960396,2017-07-02
55,23,12,2,2,94,7.670212765957447,2017-07-01
60,23,12,2,3,100,7.45,2017-06-30
58,29,9,3,2,101,7.267326732673268,2017-06-29
66,46,10,3,5,130,8.161538461538461,2017-06-28
71,51,10,5,6,143,8.286713286713287,2017-06-27
68,47,9,7,5,136,8.492647058823529,2017-06-26
72,41,11,4,5,133,8.030075187969924,2017-06-25
67,39,13,3,7,129,8.263565891472869,2017-06-24
65,40,12,5,5,127,8.0,2017-06-23
74,33,11,7,3,128,7.484375,2017-06-22
73,30,12,8,1,124,7.645161290322581,2017-06-21
66,35,9,9,0,119,7.546218487394958,2017-06-20
70,28,13,8,1,120,7.758333333333334,2017-06-19
78,29,14,9,1,131,7.824427480916031,2017-06-18
76,38,18,16,3,151,8.966887417218542,2017-06-17
78,30,21,15,2,146,8.972602739726028,2017-06-16
70,32,23,13,3,141,9.638297872340425,2017-06-15
69,29,27,8,3,136,9.036764705882353,2017-06-14
55,29,31,12,7,134,10.925373134328359,2017-06-13
56,40,33,11,7,147,10.904761904761905,2017-06-12
58,43,31,8,7,147,10.285714285714286,2017-06-11
51,45,31,11,4,142,10.274647887323944,2017-06-10
51,46,27,8,4,136,9.705882352941176,2017-06-09
45,45,21,8,5,124,10.5,2017-06-08
54,44,22,9,7,136,10.75,2017-06-07
52,52,20,7,7,138,10.253623188405797,2017-06-06
52,71,23,7,6,159,9.91194968553459,2017-06-05
63,64,19,10,3,159,9.251572327044025,2017-06-04
67,65,20,8,3,163,8.730061349693251,2017-06-03
73,48,17,10,2,150,8.726666666666667,2017-06-02
69,43,14,11,3,140,9.042857142857143,2017-06-01
78,39,13,9,3,142,8.19718309859155,2017-05-31
80,41,10,11,2,144,7.763888888888889,2017-05-30
73,45,14,10,1,143,7.7972027972027975,2017-05-29
80,30,17,5,1,133,7.30827067669173,2017-05-28
67,41,12,5,0,125,7.576,2017-05-27
64,38,13,3,0,118,7.296610169491525,2017-05-26
66,30,14,3,1,114,7.175438596491228,2017-05-25
71,21,13,3,1,109,6.779816513761468,2017-05-24
69,24,14,2,1,110,6.672727272727273,2017-05-23
54,28,12,1,1,96,6.78125,2017-05-22
